SL_NO,STATE_NAME,UNIVERSITY_NAME,COLLEGE_NAME,DISTRICT_NAME,TYPE_OF_DIPLOMA_INSTITUTE,STUDENT_ENROLMENT_MALE,STUDENT_ENROLMENT_FEMALE,STUDENT_ENROLMENT_TOTAL,NUMBER_OF_TEACHER_MALE,NUMBER_OF_TEACHER_FEMALE,NUMBER_OF_TEACHER_TOTAL,LAB_FACILITIES,HOSTEL_FACILITIES,STUDENT_FACULTY_RATIO,SCORE
1,Andhra Pradesh,Acharya Nagarjuna University Guntur (Id: U0003),Aazad College of Education (Id: C39230),Prakasam,Teacher Training,77,23,100,8,2,10,1,0,10,6.67
2,Andhra Pradesh,Acharya Nagarjuna University Guntur (Id: U0003),Ali College of Education (Id: C39243),Guntur,Teacher Training,62,38,100,7,3,10,0,0,10,3.34
3,Andhra Pradesh,Acharya Nagarjuna University Guntur (Id: U0003),Navya Chaitanya College of Education (Id: C32758),Prakasam,Teacher Training,54,46,100,7,3,10,0,0,10,3.34
4,Andhra Pradesh,Acharya Nagarjuna University Guntur (Id: U0003),Vellanki College of Education (Id: C37213),Guntur,Teacher Training,0,0,0,0,0,0,0,1,0,3.34
5,Andhra Pradesh,Andhra University Visakhapatnam (Id: U0006),J.BEERA COLLEGE OF EDUCATION (Id: C24082),West Godavari,Teacher Training,27,73,100,4,3,7,1,1,14.29,11.43
6,Andhra Pradesh,Andhra University Visakhapatnam (Id: U0006),Madhu College of Education (Id: C24307),Visakhapatnam,Teacher Training,31,65,96,6,3,9,0,1,10.67,6.89
7,Andhra Pradesh,Andhra University Visakhapatnam (Id: U0006),Minerva College of Education (Id: C24380),East Godavari,Teacher Training,56,64,120,9,1,10,0,0,12,4
8,Andhra Pradesh,Andhra University Visakhapatnam (Id: U0006),Mohan College Of Education (Id: C24071),East Godavari,Teacher Training,40,60,100,5,3,8,0,1,12.5,7.5
9,Andhra Pradesh,Andhra University Visakhapatnam (Id: U0006),St. Johns College of Education Eluru. (Id: C39226),West Godavari,Teacher Training,0,0,0,0,0,0,0,0,0,0
10,Andhra Pradesh,Andhra University Visakhapatnam (Id: U0006),Yanamadala Kamala College of Education (Id: C24123),Vizianagaram,Teacher Training,49,51,100,8,0,8,1,1,12.5,10.84
11,Andhra Pradesh,Dr. N.T.R. University of Health Sciences Vijaywada (Id: U0008),Aditya College of Nursing Kakinada (Id: C30465),East Godavari,Nursing,0,0,0,0,0,0,1,1,0,6.67
12,Andhra Pradesh,Dr. N.T.R. University of Health Sciences Vijaywada (Id: U0008),Aragonda Apollo College of Nursing Aragonda (Id: C30328),Chittoor,Nursing,0,0,0,0,0,0,1,1,0,6.67
13,Andhra Pradesh,Dr. N.T.R. University of Health Sciences Vijaywada (Id: U0008),ASRAM College of Nursing Eluru (Id: C30477),West Godavari,Nursing,58,249,307,24,48,72,0,1,4.27,4.76
14,Andhra Pradesh,Dr. N.T.R. University of Health Sciences Vijaywada (Id: U0008),Ayushman Nursing College Kurnool (Id: C30664),Kurnool,Nursing,0,76,76,0,16,16,1,0,4.75,4.92
15,Andhra Pradesh,Dr. N.T.R. University of Health Sciences Vijaywada (Id: U0008),Bollineni College of Nursing Nellore (Id: C30427),Sri Potti Sriramulu Nellore,Nursing,0,0,0,0,0,0,1,0,0,3.34
16,Andhra Pradesh,Dr. N.T.R. University of Health Sciences Vijaywada (Id: U0008),Chaitanya College of B.Sc Nursing Ongole (Id: C30417),Prakasam,Nursing,0,85,85,7,10,17,0,1,5,5
17,Andhra Pradesh,Dr. N.T.R. University of Health Sciences Vijaywada (Id: U0008),Crescent College of Nursing Kadapa (Id: C30578),Y.S.R.,Nursing,0,65,65,0,27,27,0,1,2.41,4.14
18,Andhra Pradesh,Dr. N.T.R. University of Health Sciences Vijaywada (Id: U0008),Divya College of Nursing Anantapur (Id: C30637),Anantapur,Nursing,0,0,0,0,0,0,1,0,0,3.34
19,Andhra Pradesh,Dr. N.T.R. University of Health Sciences Vijaywada (Id: U0008),Florence Nightingale Modern B.Sc Nursing Degree College For Women Kadapa (Id: C30608),Y.S.R.,Nursing,0,162,162,0,24,24,1,1,6.75,8.92
20,Andhra Pradesh,Dr. N.T.R. University of Health Sciences Vijaywada (Id: U0008),MIMS College of Nursing Nellimarla (Id: C30554),Vizianagaram,Nursing,0,86,86,0,30,30,1,0,2.87,4.29
21,Andhra Pradesh,Dr. N.T.R. University of Health Sciences Vijaywada (Id: U0008),Sanjivi B.Sc Degree College of Nursing Guntur (Id: C30371),Guntur,Nursing,0,26,26,1,12,13,0,1,2,4
22,Andhra Pradesh,Dr. N.T.R. University of Health Sciences Vijaywada (Id: U0008),Sri Sai saran College of Nursing Rajahmundry (Id: C30496),East Godavari,Nursing,0,90,90,0,36,36,1,1,2.5,7.5
23,Andhra Pradesh,Dr. N.T.R. University of Health Sciences Vijaywada (Id: U0008),Sri Venkatadri College of Nursing Kadapa (Id: C30604),Y.S.R.,Nursing,0,84,84,0,26,26,0,1,3.24,4.42
24,Andhra Pradesh,Dr. N.T.R. University of Health Sciences Vijaywada (Id: U0008),St. Anns College of Nursing Guntur (Id: C30344),Guntur,Nursing,0,174,174,0,37,37,1,1,4.71,8.24
25,Andhra Pradesh,Jawaharlal Nehru Technological University Anantapur (Id: U0016),Anjan Narasimha Munaga Kancharla Thummapudi Institute of Technology and Management Badvel (Id: C26933),Y.S.R.,Technical/Polytechnic,176,9,185,26,1,27,0,0,6.86,2.29
26,Andhra Pradesh,Jawaharlal Nehru Technological University Anantapur (Id: U0016),Gokulakrishna College of Engineering Sullerpet (Id: C26959),Sri Potti Sriramulu Nellore,Technical/Polytechnic,1497,419,1916,103,66,169,0,1,11.34,7.12
27,Andhra Pradesh,Jawaharlal Nehru Technological University Anantapur (Id: U0016),Priyadarshini College of Engineering (G1) Sullurpet (Id: C26957),Sri Potti Sriramulu Nellore,Technical/Polytechnic,505,205,710,56,34,90,0,1,7.89,5.97
28,Andhra Pradesh,Jawaharlal Nehru Technological University Anantapur (Id: U0016),Sree Kalahastheeswara Institute of Technology Sreekalahasti (Id: C26956),Chittoor,Technical/Polytechnic,1590,445,2035,25,8,33,1,1,61.67,27.23
29,Andhra Pradesh,Jawaharlal Nehru Technological University Anantapur (Id: U0016),Sri Vidyaniketan Engineering College Tirupathi (Id: C26929),Chittoor,Technical/Polytechnic,0,0,0,0,0,0,1,0,0,3.34
30,Andhra Pradesh,Jawaharlal Nehru Technological University Kakinada (Id: U0015),Kakinada Institute of Technological SciencesA Agraharam(V) Ramachandrapuram533255 (CCJP) (Id: C17973),East Godavari,Technical/Polytechnic,0,0,0,0,0,0,1,1,0,6.67
31,Andhra Pradesh,Jawaharlal Nehru Technological University Kakinada (Id: U0015),Nova's Institute of TechnologyTANGELLAMUDI VILLAGE ELURU MANDAL PIN534005(CC9F) (Id: C18017),West Godavari,Technical/Polytechnic,0,0,0,0,0,0,0,0,0,0
32,Andhra Pradesh,Jawaharlal Nehru Technological University Kakinada (Id: U0015),Sarada Institute of Science Technology And Management (SISTAM) Ampolu RoadPIN532404(CC51) (Id: C18163),Srikakulam,Technical/Polytechnic,757,187,944,124,47,171,0,1,5.53,5.18
33,Andhra Pradesh,Jawaharlal Nehru Technological University Kakinada (Id: U0015),Sri Sivani College of Engineering Chilakapalem Junction Etcherla Mandal PIN532402 (CCW6) (Id: C18111),Srikakulam,Technical/Polytechnic,0,0,0,0,0,0,0,1,0,3.34
34,Andhra Pradesh,Jawaharlal Nehru Technological University Kakinada (Id: U0015),Sri Vatsavai Krishnam Raju College of Engineering and Technology Gollala Koderu Palakoderu (Mandal) Bhimavaram. PIN534202(CCMR) (Id: C18147),West Godavari,Teacher Training,0,0,0,0,0,0,0,0,0,0
35,Andhra Pradesh,Jawaharlal Nehru Technological University Kakinada (Id: U0015),VIG0N INSTITUTE OF PHARMACEUTICAL TECHNOLOGY Beside VSEZ Vadlapudi (PO)Jaggarajupeta(V)Gajuwaka PIN530049(CCAC)) (Id: C18033),Visakhapatnam,Technical/Polytechnic,0,0,0,0,0,0,1,0,0,3.34
36,Andhra Pradesh,Jawaharlal Nehru Technological University Kakinada (Id: U0015),VRS and YRN College of Engineering and Technology Vodarevu Road Chirala(M)523157(CCL1) (Id: C18043),Prakasam,Technical/Polytechnic,0,0,0,0,0,0,0,1,0,3.34
37,Andhra Pradesh,Rayalaseema University Kurnool (Id: U0031),JVRRM College of Education Nandyal (Id: C26251),Kurnool,Teacher Training,116,86,202,16,1,17,1,0,11.89,7.3
38,Andhra Pradesh,Sri Venkateswara University Tirupathy (Id: U0037),Global Institute of Advance Study in Education Palamaner (Id: C27690),Chittoor,Teacher Training,0,0,0,0,0,0,0,0,0,0
39,Andhra Pradesh,Vikram Simhapuri University Nellore (Id: U0044),St Mari College of Education Buchireddypalem (Id: C24778),Sri Potti Sriramulu Nellore,Teacher Training,47,53,100,7,4,11,1,1,9.1,9.7
40,Andhra Pradesh,Yogi Vemana University Kadapa (Id: U0045),DAW Degree College (Id: C30303),Y.S.R.,Technical/Polytechnic,0,0,0,0,0,0,1,0,0,3.34
41,Assam,Dibrugarh University Dibrugarh (Id: U0051),D.D.R. College P.O. Chabua786184 (Id: C8402),Dibrugarh,Technical/Polytechnic,262,298,560,19,14,33,0,0,16.97,5.66
42,Assam,Gauhati University Guwahati (Id: U0052),Dr. B. Borooah Cancer Institute (Id: C17283),Kamrup,Technical/Polytechnic,3,1,4,3,1,4,1,1,1,7
43,Bihar,Aryabhatta Knoweledge University  Patna (Id: U0057),Mahavir Cancer Sansthan (Id: C49568),Patna,Nursing,18,2,20,3,4,7,0,1,2.86,4.29
44,Bihar,Bhupendra Narayan Mandal University Madhepura (Id: U0059),M.I.T. Rambagh (Id: C29598),Purnia,Technical/Polytechnic,0,0,0,0,0,0,1,0,0,3.34
45,Bihar,Jai Prakash Vishwavidyalaya Chapra (Id: U0066),Gopeshwar CollegeHathua (Id: C19496),Gopalganj,Technical/Polytechnic,1892,2408,4300,13,0,13,1,1,330.77,116.93
46,Bihar,Magadh University Bodh Gaya (Id: U0069),M.D.College Naubatpur (Id: C12961),Patna,Technical/Polytechnic,395,358,753,15,2,17,1,0,44.3,18.1
47,Bihar,Maulana Azad National Urdu University Hyderabad (Id: U0023),MANUU POLYTECHNIC DARBHANGA (Id: C46612),Darbhanga,Technical/Polytechnic,288,33,321,18,0,18,1,0,17.84,9.28
48,Bihar,Veer Kunwar Singh University Arrah (Id: U0077),Harinarayan Singh Institute of Teachers Education Sasaram (Id: C36588),Rohtas,Teacher Training,31,69,100,7,4,11,0,0,9.1,3.04
49,Chandigarh,Panjab UniversityChandigarh (Id: U0078),Chandigarh College of Engineering and Technology Sector26 (Id: C29359),Chandigarh,Technical/Polytechnic,946,108,1054,31,22,53,0,0,19.89,6.63
50,Chhatisgarh,Ayush and Health Science University of Chattisgarh Raipur (Id: U0081),C.G. COLLEGE OF NURSING SECT.02 BAJAJ COLONY NEW RAJENDRA 0GAR (Id: C32977),Raipur,Nursing,6,34,40,9,11,20,0,1,2,4
51,Chhatisgarh,Ayush and Health Science University of Chattisgarh Raipur (Id: U0081),GOVT.COLLEGE OF NURSING KAWARDHAOLD DISTT. HOSPITAL CAMPUS (Id: C32969),Kabeerdham,Nursing,0,1,1,0,7,7,0,1,0.15,3.39
52,Chhatisgarh,Ayush and Health Science University of Chattisgarh Raipur (Id: U0081),M.J.COLLEGE OF NURSING KOHKA JUNWANI ROAD NEAR C.B.S.C. SUBSTATION BHILAI (Id: C32986),Durg,Nursing,43,90,133,4,17,21,1,0,6.34,5.45
53,Chhatisgarh,Ayush and Health Science University of Chattisgarh Raipur (Id: U0081),SHREYAS COLLEGE OF NURSING G.E.ROAD SUPELA BHILAI (Id: C32959),Durg,Nursing,24,150,174,10,28,38,0,0,4.58,1.53
54,Chhatisgarh,BILASPUR VISHWAVIDYALAYA (Id: U0636),C.P.M. Arts/Science College Sarangarh (Id: C22337),Raigarh,Technical/Polytechnic,451,402,853,13,5,18,1,0,47.39,19.13
55,Chhatisgarh,BILASPUR VISHWAVIDYALAYA (Id: U0636),D.P. Vipra College of Education Bilaspur (Id: C22347),Bilaspur,Teacher Training,54,83,137,4,8,12,1,1,11.42,10.48
56,Chhatisgarh,BILASPUR VISHWAVIDYALAYA (Id: U0636),MAHAMAYA TECHNICAL COLLEGE RATANPUR (Id: C49153),Bilaspur,Technical/Polytechnic,0,0,0,0,0,0,1,1,0,6.67
57,Chhatisgarh,BILASPUR VISHWAVIDYALAYA (Id: U0636),Panchvati Mahavidyalaya Mopka (Id: C9732),Bilaspur,Technical/Polytechnic,36,24,60,3,0,3,0,1,20,10
58,Chhatisgarh,BILASPUR VISHWAVIDYALAYA (Id: U0636),SANSKRITI MAHAVIDYALAYA MEU PAMGARH (Id: C49159),Janjgir  Champa,Technical/Polytechnic,0,0,0,0,0,0,0,0,0,0
59,Chhatisgarh,Chhattisgarh Swami Vivekanand Technical University Bhilai (Id: U0083),AGRASEN POLYTECHNIC COLLEGE DAGANIA (Id: C49636),Janjgir  Champa,Technical/Polytechnic,0,0,0,0,0,0,0,1,0,3.34
60,Chhatisgarh,Chhattisgarh Swami Vivekanand Technical University Bhilai (Id: U0083),BHARTI COLLEGE OF POLYTECHNIC DURG (Id: C49522),Durg,Technical/Polytechnic,0,0,0,0,0,0,1,0,0,3.34
61,Chhatisgarh,Chhattisgarh Swami Vivekanand Technical University Bhilai (Id: U0083),B R P Govt. Polytechnic Dhamatari (Id: C16660),Dhamtari,Technical/Polytechnic,626,234,860,14,9,23,1,0,37.4,15.8
62,Chhatisgarh,Chhattisgarh Swami Vivekanand Technical University Bhilai (Id: U0083),Columbia College of Pharmacy Raipur (Id: C16632),Raipur,Technical/Polytechnic,77,43,120,4,3,7,0,1,17.15,9.05
63,Chhatisgarh,Chhattisgarh Swami Vivekanand Technical University Bhilai (Id: U0083),Garv Institute of Management and Technology Purai Bhilai (Id: C16640),Durg,Technical/Polytechnic,0,0,0,0,0,0,1,1,0,6.67
64,Chhatisgarh,Chhattisgarh Swami Vivekanand Technical University Bhilai (Id: U0083),Girls Polytechnic Raipur (Id: C16309),Raipur,Technical/Polytechnic,0,586,586,30,34,64,0,1,9.16,6.39
65,Chhatisgarh,Chhattisgarh Swami Vivekanand Technical University Bhilai (Id: U0083),Girls Polytechnic Rajnandgaon (Id: C16305),Rajnandgaon,Technical/Polytechnic,0,182,182,8,6,14,0,0,13,4.34
66,Chhatisgarh,Chhattisgarh Swami Vivekanand Technical University Bhilai (Id: U0083),Governement Polytechnic College Korea Baikunthpur Korea (Id: C16653),Koriya,Technical/Polytechnic,263,58,321,9,7,16,0,0,20.07,6.69
67,Chhatisgarh,Chhattisgarh Swami Vivekanand Technical University Bhilai (Id: U0083),GOVERNMENT POLYTECHINC RAMANUJGANJ OLD TEHSIL OFFICE (Id: C49655),Surguja,Technical/Polytechnic,0,0,0,0,0,0,0,0,0,0
68,Chhatisgarh,Chhattisgarh Swami Vivekanand Technical University Bhilai (Id: U0083),GOVERNMENT POLYTECHNIC SUKMA (Id: C49639),Dakshin Bastar Dantewada,Technical/Polytechnic,0,0,0,0,0,0,0,1,0,3.34
69,Chhatisgarh,Chhattisgarh Swami Vivekanand Technical University Bhilai (Id: U0083),Govt. Girls Polytechnic Bilaspur (Id: C15590),Bilaspur,Technical/Polytechnic,0,325,325,5,4,9,1,0,36.12,15.38
70,Chhatisgarh,Chhattisgarh Swami Vivekanand Technical University Bhilai (Id: U0083),Govt.Girls Polytechnic Jagdalpur (Id: C16308),Bastar,Technical/Polytechnic,9,272,281,9,15,24,1,1,11.71,10.57
71,Chhatisgarh,Chhattisgarh Swami Vivekanand Technical University Bhilai (Id: U0083),Govt.Polytechnic Ambikapur (Id: C15592),Surguja,Technical/Polytechnic,562,174,736,40,8,48,1,0,15.34,8.45
72,Chhatisgarh,Chhattisgarh Swami Vivekanand Technical University Bhilai (Id: U0083),Govt. Polytechnic Bijapur (Id: C15599),Bijapur,Technical/Polytechnic,209,22,231,4,2,6,1,1,38.5,19.5
73,Chhatisgarh,Chhattisgarh Swami Vivekanand Technical University Bhilai (Id: U0083),Govt.Polytechnic Durg (Id: C15644),Durg,Technical/Polytechnic,909,323,1232,12,13,25,0,1,49.28,19.76
74,Chhatisgarh,Chhattisgarh Swami Vivekanand Technical University Bhilai (Id: U0083),Govt. Polytechnic Gariyaband (Id: C19114),Raipur,Technical/Polytechnic,188,27,215,2,0,2,1,1,107.5,42.5
75,Chhatisgarh,Chhattisgarh Swami Vivekanand Technical University Bhilai (Id: U0083),Govt.Polytechnic Janjgir Champa (Id: C16633),Janjgir  Champa,Teacher Training,268,82,350,9,4,13,0,1,26.93,12.31
76,Chhatisgarh,Chhattisgarh Swami Vivekanand Technical University Bhilai (Id: U0083),Govt. Polytechnic  Jashpur. (Id: C15655),Jashpur,Technical/Polytechnic,226,32,258,7,2,9,1,0,28.67,12.89
77,Chhatisgarh,Chhattisgarh Swami Vivekanand Technical University Bhilai (Id: U0083),Govt.Polytechnic Kabirdham Kawardha (Id: C15634),Kabeerdham,Technical/Polytechnic,207,21,228,12,6,18,0,0,12.67,4.23
78,Chhatisgarh,Chhattisgarh Swami Vivekanand Technical University Bhilai (Id: U0083),Govt. Polytechnic Kanker (Id: C15675),Uttar Bastar Kanker,Technical/Polytechnic,224,54,278,13,5,18,1,1,15.45,11.82
79,Chhatisgarh,Chhattisgarh Swami Vivekanand Technical University Bhilai (Id: U0083),Govt.Polytechnic Khairagarh (Id: C15597),Rajnandgaon,Technical/Polytechnic,556,0,556,13,7,20,0,0,27.8,9.27
80,Chhatisgarh,Chhattisgarh Swami Vivekanand Technical University Bhilai (Id: U0083),Govt.PolytechnicKorba (Id: C16307),Korba,Technical/Polytechnic,628,123,751,10,9,19,1,1,39.53,19.85
81,Chhatisgarh,Chhattisgarh Swami Vivekanand Technical University Bhilai (Id: U0083),Govt. Polytechnic Mahasamund (Id: C15633),Mahasamund,Technical/Polytechnic,291,81,372,14,6,20,0,0,18.6,6.2
82,Chhatisgarh,Chhattisgarh Swami Vivekanand Technical University Bhilai (Id: U0083),Govt. Polytechnic Narayanpur (Id: C15604),Narayanpur,Technical/Polytechnic,155,21,176,13,12,25,1,0,7.04,5.68
83,Chhatisgarh,Chhattisgarh Swami Vivekanand Technical University Bhilai (Id: U0083),Govt. Polytechnic Raigarh (Id: C16306),Raigarh,Technical/Polytechnic,935,224,1159,28,14,42,0,1,27.6,12.54
84,Chhatisgarh,Chhattisgarh Swami Vivekanand Technical University Bhilai (Id: U0083),Govt.Polytechnic Takhatpur (Id: C15635),Bilaspur,Technical/Polytechnic,222,30,252,12,3,15,1,1,16.8,12.27
85,Chhatisgarh,Chhattisgarh Swami Vivekanand Technical University Bhilai (Id: U0083),IBT College of Diploma Engg.Berla Road Ahiwara Nandini Road (Id: C15612),Durg,Technical/Polytechnic,0,0,0,0,0,0,0,1,0,3.34
86,Chhatisgarh,Chhattisgarh Swami Vivekanand Technical University Bhilai (Id: U0083),J K Institute of Pharmacy Near Gatora Railway Station (Id: C15637),Bilaspur,Technical/Polytechnic,87,26,113,6,2,8,1,0,14.13,8.05
87,Chhatisgarh,Chhattisgarh Swami Vivekanand Technical University Bhilai (Id: U0083),Mansa Polytechnic Kohka Kurud Road. Bhilai. (Id: C15672),Durg,Technical/Polytechnic,612,12,624,23,17,40,1,1,15.6,11.87
88,Chhatisgarh,Chhattisgarh Swami Vivekanand Technical University Bhilai (Id: U0083),Moulana Abul Kalam Azad College of Pharmacy Navdurga Nagar Mathpurena (Id: C15606),Raipur,Technical/Polytechnic,86,8,94,4,2,6,1,1,15.67,11.89
89,Chhatisgarh,Chhattisgarh Swami Vivekanand Technical University Bhilai (Id: U0083),NMDC DAV Polytechnic Dantewada (Id: C15626),Dakshin Bastar Dantewada,Technical/Polytechnic,343,15,358,7,5,12,0,0,29.84,9.95
90,Chhatisgarh,Chhattisgarh Swami Vivekanand Technical University Bhilai (Id: U0083),Royal College of Pharmacy Sanjay Nagar Ring Road No 1 (Id: C15613),Raipur,Technical/Polytechnic,0,0,0,0,0,0,0,0,0,0
91,Chhatisgarh,Chhattisgarh Swami Vivekanand Technical University Bhilai (Id: U0083),SHRI SAI POLYTECHNIC DEURJHAL 0NDINI (Id: C49637),Durg,Technical/Polytechnic,0,0,0,0,0,0,1,0,0,3.34
92,Chhatisgarh,Chhattisgarh Swami Vivekanand Technical University Bhilai (Id: U0083),Siddhi Vinayak Institute of Technology and Science (College of Pharmacy) Near Balram Talkies Nehru Nagar (Id: C16647),Bilaspur,Technical/Polytechnic,125,37,162,13,7,20,0,1,8.1,6.04
93,Chhatisgarh,Guru Ghasidas Vishwavidyalaya Bilaspur (Id: U0085),C.P.M. Arts/Science College Sarangarh (Id: C22337),Raigarh,Technical/Polytechnic,451,402,853,13,5,18,0,1,47.39,19.13
94,Chhatisgarh,Guru Ghasidas Vishwavidyalaya Bilaspur (Id: U0085),D.P. Vipra College of Education Bilaspur (Id: C22347),Bilaspur,Teacher Training,54,83,137,4,8,12,1,0,11.42,7.14
95,Chhatisgarh,Indira Kala Sangit Vishwavidyalaya Khairagarh (Id: U0088),Nagarpalika Sharada Sangeet MahavidyalayaKawardha 491 995 (Id: C33080),Kabeerdham,Teacher Training,0,0,0,0,0,0,0,0,0,0
96,Chhatisgarh,Kushabhau Thakre Patrakarita Avam Jansanchar Vishwavidyalaya Raipur (Id: U0089),Mahant Laximidas College Raipur (Id: C26388),Raipur,Teacher Training,0,0,0,0,0,0,0,0,0,0
97,Chhatisgarh,Pt. Ravishankar Shukla University Raipur (Id: U0093),Confluence College of Higher Education Rajnandgaon (Id: C21829),Rajnandgaon,Teacher Training,236,270,506,13,19,32,0,0,15.82,5.28
98,Chhatisgarh,Pt. Ravishankar Shukla University Raipur (Id: U0093),Dr. Rajendra Prasad Art. and Comm College Risali Bhilai (Id: C21713),Durg,Teacher Training,39,61,100,4,5,9,1,0,11.12,7.04
99,Chhatisgarh,Pt. Ravishankar Shukla University Raipur (Id: U0093),Govt Dr. Vaman Vasudev Patankar Girls (Id: C21647),Durg,Teacher Training,0,2180,2180,3,28,31,1,1,70.33,30.11
100,Chhatisgarh,Pt. Ravishankar Shukla University Raipur (Id: U0093),Indian College of Education Station Road (Id: C21749),Mahasamund,Technical/Polytechnic,0,0,0,0,0,0,0,0,0,0
101,Chhatisgarh,Pt. Ravishankar Shukla University Raipur (Id: U0093),TakshShila Mahavidayalya Civic Center Engineers Bhawan Bhilai (Id: C21856),Durg,Technical/Polytechnic,0,0,0,0,0,0,1,0,0,3.34
102,Chhatisgarh,Pt. Ravishankar Shukla University Raipur (Id: U0093),Vivekanand Education Institute Ram Krishna Parmhansh Kota (Id: C21823),Raipur,Teacher Training,40,59,99,1,5,6,1,1,16.5,12.17
103,Chhatisgarh,Sarguja University Ambikapur (Id: U0095),Ayush College of Education Marvahi Village Lohari (Id: C9763),Bilaspur,Teacher Training,0,0,0,0,0,0,1,1,0,6.67
104,Chhatisgarh,Sarguja University Ambikapur (Id: U0095),Panchvati Mahavidyalaya Mopka (Id: C9732),Bilaspur,Technical/Polytechnic,36,24,60,3,0,3,1,1,20,13.34
105,Dadra and Nagar Haveli,Gujarat Technological University Ahmedbabd (Id: U0135),DR B B A GOVERNMENT POLYTECHNIC (Id: C47929),Dadra and Nagar Haveli,Technical/Polytechnic,540,105,645,24,7,31,1,1,20.81,13.61
106,Daman and Diu,Gujarat Technological University Ahmedbabd (Id: U0135),GOVERNMENT POLYTECHNIC DAMAN658 (Id: C48754),Daman,Technical/Polytechnic,0,0,0,0,0,0,1,0,0,3.34
107,Delhi,Guru Gobind Singh Indraprastha University (Id: U0099),Jagan Institute of Management Studies (Rohini) (Id: C32855),North West,Technical/Polytechnic,0,0,0,0,0,0,1,1,0,6.67
108,Delhi,Indira Kala Sangit Vishwavidyalaya Khairagarh (Id: U0088),Sangeet NiketanNew Delhi (Id: C33029),New Delhi,Technical/Polytechnic,88,248,336,5,8,13,0,0,25.85,8.62
109,Delhi,University of Delhi (Id: U0120),Daulat Ram College (Id: C6367),North,Technical/Polytechnic,0,0,0,0,0,0,1,0,0,3.34
110,Delhi,University of Delhi (Id: U0120),School of Rehabilitation Sciences (Id: C6392),South,Teacher Training,0,0,0,0,4,4,0,0,0,0
111,Goa,Goa University Goa (Id: U0121),GOA COLLEGE OF HOSPITALITY AND CULI0RY EDUCATION CIDADEDEGOA (Id: C46325),North Goa,Technical/Polytechnic,19,3,22,4,1,5,0,0,4.4,1.47
112,Gujarat,Ahmedabad University (Id: U0122),PHYSIOTHERAPY COLLEGE FOR VISUALLY IMPAIRED (Id: C50452),Ahmadabad,Nursing,0,0,0,0,0,0,0,1,0,3.34
113,Gujarat,Anand Agricultural University Anand (Id: U0123),Polytechnic in Agricultural Engineering Dahod (Id: C7235),Dohad,Technical/Polytechnic,77,15,92,5,0,5,0,1,18.4,9.47
114,Gujarat,Anand Agricultural University Anand (Id: U0123),Polytechnic in Agriculture Vaso (Id: C7227),Kheda,Technical/Polytechnic,99,1,100,3,0,3,0,1,33.34,14.45
115,Gujarat,Anand Agricultural University Anand (Id: U0123),Polytechnic in Food Science and Home Economics  Anand (Id: C7234),Anand,Technical/Polytechnic,44,42,86,1,2,3,1,1,28.67,16.23
116,Gujarat,Anand Agricultural University Anand (Id: U0123),Sheth D.M.Polytehnic in Horticulture Vadodara (Id: C7237),Vadodara,Technical/Polytechnic,76,22,98,4,0,4,1,0,24.5,11.5
117,Gujarat,Anand Agricultural University Anand (Id: U0123),Sheth M.C.Polytehnic in Agriculture  Anand (Id: C7236),Anand,Technical/Polytechnic,83,22,105,5,0,5,0,0,21,7
118,Gujarat,Gujarat Ayurveda University Jamnagar (Id: U0133),Government Ayurved College Vadodara (Id: C6448),Vadodara,Technical/Polytechnic,26,115,141,16,17,33,0,0,4.28,1.43
119,Gujarat,Gujarat Ayurveda University Jamnagar (Id: U0133),Maharshi Patanjali Institute for Yoga Naturopathy Education and Research (Id: C6441),Jamnagar,Teacher Training,0,0,0,0,0,0,1,0,0,3.34
120,Gujarat,Gujarat Technological University Ahmedbabd (Id: U0135),031 Lakhdhirji Enggniering collegeMorbi. (Id: C191),Rajkot,Technical/Polytechnic,1406,155,1561,50,12,62,0,0,25.18,8.4
121,Gujarat,Gujarat Technological University Ahmedbabd (Id: U0135),035 NOBLE ENGINEERING COLLEGE JU0GADH (Id: C213),Junagadh,Technical/Polytechnic,2148,290,2438,112,52,164,0,1,14.87,8.29
122,Gujarat,Gujarat Technological University Ahmedbabd (Id: U0135),037 PARUL INSTITUTE OF ENGG. AND TECH. LIMDA VAGHODIA (Id: C131),Vadodara,Technical/Polytechnic,0,0,0,0,0,0,0,1,0,3.34
123,Gujarat,Gujarat Technological University Ahmedbabd (Id: U0135),051 ALPHA COLLEGE OF ENGG. and TECH. KHATRAJ KALOL (Id: C207),Gandhinagar,Technical/Polytechnic,1573,304,1877,85,36,121,1,0,15.52,8.51
124,Gujarat,Gujarat Technological University Ahmedbabd (Id: U0135),075 SHANKERSINH VAGHELA BAPU INSTITUTE OF TECH. U0VA GANDHI0GAR (Id: C266),Gandhinagar,Technical/Polytechnic,0,0,0,0,0,0,1,0,0,3.34
125,Gujarat,Gujarat Technological University Ahmedbabd (Id: U0135),406 Dr. Dayaram Patel Pharmacy College (Diploma) Bardoli Surat (Id: C459),Surat,Technical/Polytechnic,18,26,44,2,2,4,0,0,11,3.67
126,Gujarat,Gujarat Technological University Ahmedbabd (Id: U0135),408 L. M. College Of Pharmacy (Diploma) (Id: C458),Ahmadabad,Technical/Polytechnic,44,45,89,4,5,9,1,1,9.89,9.97
127,Gujarat,Gujarat Technological University Ahmedbabd (Id: U0135),409 M. N. College Of Pharmacy (Diploma) Khambhat (Id: C457),Anand,Technical/Polytechnic,61,33,94,5,1,6,1,0,15.67,8.56
128,Gujarat,Gujarat Technological University Ahmedbabd (Id: U0135),414 Shantilal Shah Pharmacy College (Diploma) (Id: C463),Bhavnagar,Technical/Polytechnic,31,18,49,5,1,6,0,0,8.17,2.73
129,Gujarat,Gujarat Technological University Ahmedbabd (Id: U0135),415 Shri B. M. Shah College Of Pharmacy (Diploma) Modasa (Id: C464),Sabar Kantha,Technical/Polytechnic,11,12,23,4,1,5,1,1,4.6,8.2
130,Gujarat,Gujarat Technological University Ahmedbabd (Id: U0135),417 Tolani Institute Of Pharmacy (Diploma) Adipur (Id: C465),Kachchh,Technical/Polytechnic,25,14,39,1,3,4,1,1,9.75,9.92
131,Gujarat,Gujarat Technological University Ahmedbabd (Id: U0135),525 Parul Institute of Engineering and TechnologyMCA Programme (SFI)Vadodara (Id: C155),Vadodara,Technical/Polytechnic,82,52,134,8,6,14,0,0,9.58,3.2
132,Gujarat,Gujarat Technological University Ahmedbabd (Id: U0135),601 A. Y. Dadabhai Technical Institute Kosamba (Id: C364),Surat,Technical/Polytechnic,1014,134,1148,39,16,55,0,1,20.88,10.3
133,Gujarat,Gujarat Technological University Ahmedbabd (Id: U0135),602 A.V.Parekh Technical InstituteRajkot (Id: C50),Rajkot,Technical/Polytechnic,1429,692,2121,42,22,64,1,0,33.15,14.39
134,Gujarat,Gujarat Technological University Ahmedbabd (Id: U0135),603 Atmiya institue of Technology and Science for Diploma Studies Yogi Devine Soc Rajkot (Id: C61),Rajkot,Technical/Polytechnic,1419,254,1673,64,23,87,1,0,19.23,9.75
135,Gujarat,Gujarat Technological University Ahmedbabd (Id: U0135),604 B and B Institute of TechnologyVallabh Vidhyanagar  GIA (Id: C166),Anand,Technical/Polytechnic,837,293,1130,46,6,52,1,0,21.74,10.58
136,Gujarat,Gujarat Technological University Ahmedbabd (Id: U0135),605 B and B Institute of TechnologyVallabh Vidhyanagar (SFI) (Id: C422),Anand,Technical/Polytechnic,541,151,692,22,7,29,0,0,23.87,7.96
137,Gujarat,Gujarat Technological University Ahmedbabd (Id: U0135),606 Butler Polytechnic Vadodara (Id: C59),Vadodara,Technical/Polytechnic,456,94,550,16,11,27,0,0,20.38,6.8
138,Gujarat,Gujarat Technological University Ahmedbabd (Id: U0135),608 Bhagvan Mahavir Polytechnic Surat (Id: C78),Surat,Technical/Polytechnic,831,192,1023,54,25,79,1,0,12.95,7.65
139,Gujarat,Gujarat Technological University Ahmedbabd (Id: U0135),609 C.U.Shah PolytechnicSurendranagar (Id: C349),Surendranagar,Technical/Polytechnic,1245,273,1518,70,19,89,0,1,17.06,9.02
140,Gujarat,Gujarat Technological University Ahmedbabd (Id: U0135),610 Christ Polytechnic Institute Rajkot (Id: C32),Rajkot,Technical/Polytechnic,1696,133,1829,56,40,96,1,1,19.06,13.02
141,Gujarat,Gujarat Technological University Ahmedbabd (Id: U0135),611 Dr.J.N.Maheta Government PolytechnicAmreli (Id: C287),Amreli,Technical/Polytechnic,1434,250,1684,43,3,46,0,1,36.61,15.54
142,Gujarat,Gujarat Technological University Ahmedbabd (Id: U0135),612 Dr.S.and S.S.Gandhi college of Engg. And TechnologySurat (Id: C248),Surat,Technical/Polytechnic,2396,248,2644,72,25,97,0,0,27.26,9.09
143,Gujarat,Gujarat Technological University Ahmedbabd (Id: U0135),613 Excel Institute of Diploma StudiesKalol (Id: C297),Gandhinagar,Technical/Polytechnic,528,36,564,39,17,56,1,1,10.08,10.03
144,Gujarat,Gujarat Technological University Ahmedbabd (Id: U0135),614 Government Girls PolytechnicAhmedabad (Id: C29),Ahmadabad,Technical/Polytechnic,0,1801,1801,20,48,68,1,1,26.49,15.5
145,Gujarat,Gujarat Technological University Ahmedbabd (Id: U0135),615 Government Girls PolytechnicSurat. (Id: C385),Surat,Technical/Polytechnic,0,1744,1744,30,25,55,0,1,31.71,13.91
146,Gujarat,Gujarat Technological University Ahmedbabd (Id: U0135),616 Government Polytechnic AahvaDang (Id: C387),The Dangs,Technical/Polytechnic,378,66,444,21,2,23,1,1,19.31,13.11
147,Gujarat,Gujarat Technological University Ahmedbabd (Id: U0135),618 Government Polytechnic Godhra (Id: C357),Panch Mahals,Technical/Polytechnic,932,57,989,31,2,33,0,1,29.97,13.33
148,Gujarat,Gujarat Technological University Ahmedbabd (Id: U0135),619 Government Polytechnic Junagadh (Id: C369),Jamnagar,Technical/Polytechnic,431,50,481,25,4,29,1,0,16.59,8.87
149,Gujarat,Gujarat Technological University Ahmedbabd (Id: U0135),620 Government Polytechnic Rajkot (Id: C243),Rajkot,Technical/Polytechnic,2900,310,3210,101,21,122,0,1,26.32,12.11
150,Gujarat,Gujarat Technological University Ahmedbabd (Id: U0135),621 Government PolytechnicBhuj (Id: C56),Kachchh,Technical/Polytechnic,1986,92,2078,32,9,41,1,1,50.69,23.57
151,Gujarat,Gujarat Technological University Ahmedbabd (Id: U0135),622 Government PolytechnicChotta Udepur (Id: C277),Vadodara,Technical/Polytechnic,1214,37,1251,43,2,45,0,1,27.8,12.6
152,Gujarat,Gujarat Technological University Ahmedbabd (Id: U0135),623 Government PolytechnicGandhinagar (Id: C237),Gandhinagar,Technical/Polytechnic,2472,971,3443,57,33,90,1,0,38.26,16.09
153,Gujarat,Gujarat Technological University Ahmedbabd (Id: U0135),624 Government PolytechnicHimmatnagar (Id: C337),Sabar Kantha,Technical/Polytechnic,1621,376,1997,28,20,48,0,0,41.61,13.87
154,Gujarat,Gujarat Technological University Ahmedbabd (Id: U0135),625 Government PolytechnicJamnagar (Id: C51),Jamnagar,Technical/Polytechnic,1366,326,1692,55,22,77,0,1,21.98,10.66
155,Gujarat,Gujarat Technological University Ahmedbabd (Id: U0135),626 Government PolytechnicPalanpur (Id: C416),Banas Kantha,Technical/Polytechnic,2006,149,2155,73,12,85,0,0,25.36,8.46
156,Gujarat,Gujarat Technological University Ahmedbabd (Id: U0135),627 Government PolytechnicPorbandar (Id: C279),Porbandar,Technical/Polytechnic,1268,328,1596,44,14,58,1,0,27.52,12.51
157,Gujarat,Gujarat Technological University Ahmedbabd (Id: U0135),628 Government PolytechnicVadnagar (Id: C187),Patan,Technical/Polytechnic,372,66,438,18,10,28,0,0,15.65,5.22
158,Gujarat,Gujarat Technological University Ahmedbabd (Id: U0135),629 Government PolytechnicValsad (Id: C300),Valsad,Technical/Polytechnic,2103,238,2341,49,13,62,1,0,37.76,15.92
159,Gujarat,Gujarat Technological University Ahmedbabd (Id: U0135),630 Government PolytechnicDahod (Id: C217),Dohad,Technical/Polytechnic,1266,263,1529,67,12,79,1,1,19.36,13.12
160,Gujarat,Gujarat Technological University Ahmedbabd (Id: U0135),631 K.D.PolytechnicPatan (Id: C156),Patan,Technical/Polytechnic,2026,377,2403,74,18,92,1,0,26.12,12.04
161,Gujarat,Gujarat Technological University Ahmedbabd (Id: U0135),632 K.P.Thakkar Swa. Krishanajeevandas Insti of TechSokli (Id: C21),Ahmadabad,Technical/Polytechnic,1199,43,1242,29,7,36,0,0,34.5,11.5
162,Gujarat,Gujarat Technological University Ahmedbabd (Id: U0135),636 Merchant Polytechnic Visnagar (Id: C240),Mahesana,Technical/Polytechnic,1451,86,1537,70,17,87,0,0,17.67,5.89
163,Gujarat,Gujarat Technological University Ahmedbabd (Id: U0135),637 N.G.Patel PolytechnicIsroli (Id: C268),Surat,Technical/Polytechnic,1234,178,1412,61,11,72,1,1,19.62,13.21
164,Gujarat,Gujarat Technological University Ahmedbabd (Id: U0135),638 Parul Institute of Diploma Studies (Id: C81),Vadodara,Technical/Polytechnic,3457,604,4061,132,73,205,1,0,19.81,9.94
165,Gujarat,Gujarat Technological University Ahmedbabd (Id: U0135),639 Parul Institute of Diploma StudiesLimda (Id: C157),Vadodara,Technical/Polytechnic,1233,371,1604,44,50,94,0,1,17.07,9.03
166,Gujarat,Gujarat Technological University Ahmedbabd (Id: U0135),640 R.C.Technical InstituteAhmedabad (Id: C206),Ahmadabad,Technical/Polytechnic,2150,443,2593,92,29,121,0,0,21.43,7.15
167,Gujarat,Gujarat Technological University Ahmedbabd (Id: U0135),641 R.H.PATEL INSTI. OF TECHNOLOGYGOBLAJKHEDA (Id: C27),Kheda,Technical/Polytechnic,326,3,329,96,12,108,0,1,3.05,4.35
168,Gujarat,Gujarat Technological University Ahmedbabd (Id: U0135),642 RMS Polytechnic Waghodiya (Id: C403),Vadodara,Technical/Polytechnic,2275,133,2408,99,27,126,0,1,19.12,9.71
169,Gujarat,Gujarat Technological University Ahmedbabd (Id: U0135),643 Sarvodaya Polytechnic Institute Limbdi (Id: C158),Surendranagar,Technical/Polytechnic,1140,31,1171,49,7,56,1,1,20.92,13.64
170,Gujarat,Gujarat Technological University Ahmedbabd (Id: U0135),644 B.S.Patel PolytechnicMehsana. (Id: C200),Mahesana,Technical/Polytechnic,3298,346,3644,291,33,324,0,0,11.25,3.75
171,Gujarat,Gujarat Technological University Ahmedbabd (Id: U0135),645 Shri K.J.PolytechnicBharuch (Id: C318),Bharuch,Technical/Polytechnic,2395,680,3075,43,33,76,1,0,40.47,16.83
172,Gujarat,Gujarat Technological University Ahmedbabd (Id: U0135),646 Shri N.M.Gopani Polytechnic instituteRanpur (Id: C255),Ahmadabad,Technical/Polytechnic,2021,25,2046,88,10,98,1,0,20.88,10.3
173,Gujarat,Gujarat Technological University Ahmedbabd (Id: U0135),647 Shri Tapi Brahmcharyashram sabha college of Diploma EnggSurat. (Id: C23),Surat,Technical/Polytechnic,1147,259,1406,48,17,65,0,1,21.64,10.55
174,Gujarat,Gujarat Technological University Ahmedbabd (Id: U0135),649 Sir Bhavsinhji Polytechnic Institute Bhavnagar (Id: C288),Bhavnagar,Technical/Polytechnic,2696,436,3132,60,22,82,0,1,38.2,16.07
175,Gujarat,Gujarat Technological University Ahmedbabd (Id: U0135),650 Swami Sacchidanand Polytechnic collegeVisnagar (Id: C252),Mahesana,Technical/Polytechnic,1614,147,1761,93,17,110,1,1,16.01,12.01
176,Gujarat,Gujarat Technological University Ahmedbabd (Id: U0135),651 T.F.Gandhidham PolytechnicAdipur(Kutch) (Id: C428),Kachchh,Technical/Polytechnic,418,59,477,23,3,26,0,0,18.35,6.12
177,Gujarat,Gujarat Technological University Ahmedbabd (Id: U0135),652 Verdhman Bharti Trust Technical Institute Of Diploma Studies Wadhwan City (Id: C325),Surendranagar,Technical/Polytechnic,1049,73,1122,31,16,47,1,0,23.88,11.3
178,Gujarat,Gujarat Technological University Ahmedbabd (Id: U0135),653 Tolani FoundationGandhidham Polytechnic(SFI) (Id: C223),Kachchh,Technical/Polytechnic,590,91,681,21,11,32,0,0,21.29,7.1
179,Gujarat,Gujarat Technological University Ahmedbabd (Id: U0135),654 V.P.M.P. Polytechnic Gandhinagar (Id: C283),Gandhinagar,Technical/Polytechnic,1718,333,2051,62,32,94,1,0,21.82,10.61
180,Gujarat,Gujarat Technological University Ahmedbabd (Id: U0135),655 Vallabhbudhi polytechnic Navsari (Id: C420),Navsari,Technical/Polytechnic,1454,265,1719,62,29,91,0,0,18.9,6.3
181,Gujarat,Gujarat Technological University Ahmedbabd (Id: U0135),656 Vidhyabharti Trust Polytechnic InstituteUmrakh. (Id: C31),Surat,Technical/Polytechnic,1264,133,1397,53,13,66,0,1,21.17,10.39
182,Gujarat,Gujarat Technological University Ahmedbabd (Id: U0135),661 Ved Vyas Polytechnic Himmatnagar (Id: C293),Sabar Kantha,Technical/Polytechnic,1068,62,1130,32,10,42,1,1,26.91,15.64
183,Gujarat,Gujarat Technological University Ahmedbabd (Id: U0135),662 Darshan Inst. Of Eng. and Tech. For Diploma Studies Rajkot (Id: C232),Rajkot,Technical/Polytechnic,414,30,444,65,7,72,0,1,6.17,5.39
184,Gujarat,Gujarat Technological University Ahmedbabd (Id: U0135),663 Balaji Insti. Of Eng. and Tech Junagadh (Id: C265),Junagadh,Technical/Polytechnic,903,122,1025,49,8,57,1,1,17.99,12.67
185,Gujarat,Gujarat Technological University Ahmedbabd (Id: U0135),664 Atul Polytechnic Mansa Mahudi (Id: C203),Gandhinagar,Technical/Polytechnic,1240,78,1318,69,21,90,0,1,14.65,8.22
186,Gujarat,Gujarat Technological University Ahmedbabd (Id: U0135),665 Om Insti. Of Eng.and Technology Junagadh (Id: C210),Junagadh,Technical/Polytechnic,788,88,876,42,11,53,0,0,16.53,5.51
187,Gujarat,Gujarat Technological University Ahmedbabd (Id: U0135),666 S.B. Polytechnic Savli Vadodara (Id: C77),Vadodara,Technical/Polytechnic,1209,132,1341,39,28,67,1,1,20.02,13.34
188,Gujarat,Gujarat Technological University Ahmedbabd (Id: U0135),667 Dalia Insti. Of Diploma Studies Kheda (Id: C424),Kheda,Technical/Polytechnic,1278,92,1370,53,10,63,1,1,21.75,13.92
189,Gujarat,Gujarat Technological University Ahmedbabd (Id: U0135),668 Narayanbhai Bhikhabhai Patel PolytechnicPiludara Mehsana (Id: C215),Mahesana,Technical/Polytechnic,1233,43,1276,44,7,51,0,1,25.02,11.68
190,Gujarat,Gujarat Technological University Ahmedbabd (Id: U0135),669 Savitaben Dahyabhai Patel Polytechnic Mehsana (Id: C374),Mahesana,Technical/Polytechnic,1027,26,1053,42,8,50,0,1,21.06,10.36
191,Gujarat,Gujarat Technological University Ahmedbabd (Id: U0135),671 Swaminarayan College of Engg. Saij Kalol (Id: C363),Gandhinagar,Technical/Polytechnic,1016,122,1138,49,21,70,0,0,16.26,5.42
192,Gujarat,Gujarat Technological University Ahmedbabd (Id: U0135),674 Aarsh Mahavidyalaya TrambaRajkot (Id: C371),Rajkot,Technical/Polytechnic,1232,31,1263,63,8,71,1,1,17.79,12.6
193,Gujarat,Gujarat Technological University Ahmedbabd (Id: U0135),675 F. D.(Mubin) Institute of Engineering and Technology Dehgam Bahiyal Gandhinagar (Id: C328),Gandhinagar,Technical/Polytechnic,680,38,718,36,4,40,1,1,17.95,12.65
194,Gujarat,Gujarat Technological University Ahmedbabd (Id: U0135),676 H. B. Patel Institute of Diploma Engineering and Technology Limbodara Lunavada (Id: C184),Gandhinagar,Technical/Polytechnic,805,43,848,26,1,27,1,1,31.41,17.14
195,Gujarat,Gujarat Technological University Ahmedbabd (Id: U0135),677 Shree Hari Polytechnic Institute Nani Kadi (Id: C71),Mahesana,Technical/Polytechnic,1105,44,1149,47,11,58,0,0,19.82,6.61
196,Gujarat,Gujarat Technological University Ahmedbabd (Id: U0135),678 Balasinor College of Polytechnic Dist. Kheda (Id: C238),Kheda,Technical/Polytechnic,880,44,924,31,7,38,0,1,24.32,11.44
197,Gujarat,Gujarat Technological University Ahmedbabd (Id: U0135),679 J.J.C.E. Trust Sanchalit N.R.Vekaria Insti. Of Tech.  Junagadh (Id: C126),Junagadh,Technical/Polytechnic,282,30,312,17,12,29,0,0,10.76,3.59
198,Gujarat,Gujarat Technological University Ahmedbabd (Id: U0135),680 Arpit Institute of Engineering and Technology (Diploma)HadalaRajkot (Id: C220),Rajkot,Technical/Polytechnic,1004,27,1031,38,14,52,1,1,19.83,13.28
199,Gujarat,Gujarat Technological University Ahmedbabd (Id: U0135),681 Smt. R.S.Patel Insti. Of Diploma Engg. Shelavi Patan (Id: C54),Patan,Technical/Polytechnic,201,10,211,38,3,41,0,0,5.15,1.72
200,Gujarat,Gujarat Technological University Ahmedbabd (Id: U0135),682 D.A. Diploma Engg. and Technology Mahemdavad (Id: C177),Kheda,Technical/Polytechnic,991,70,1061,38,11,49,0,0,21.66,7.22
201,Gujarat,Gujarat Technological University Ahmedbabd (Id: U0135),683 Image Engg. And Technology Institute Kheda (Id: C205),Kheda,Technical/Polytechnic,752,19,771,46,11,57,0,0,13.53,4.51
202,Gujarat,Gujarat Technological University Ahmedbabd (Id: U0135),738 Noble Engineering College(MBA Course) (SFI) Bamangam Junagadh (Id: C193),Junagadh,Technical/Polytechnic,54,65,119,4,5,9,0,1,13.23,7.75
203,Gujarat,Gujarat Technological University Ahmedbabd (Id: U0135),Aarsh Mahavidyalaya TrambaRajkot 674 (Id: C371),Rajkot,Technical/Polytechnic,1232,31,1263,63,8,71,0,0,17.79,5.93
204,Gujarat,Gujarat Technological University Ahmedbabd (Id: U0135),ALPHA COLLEGE OF ENGINEERING AND TECHNOLOGY694 (Id: C49595),Gandhinagar,Technical/Polytechnic,0,0,0,0,0,0,0,0,0,0
205,Gujarat,Gujarat Technological University Ahmedbabd (Id: U0135),Amrut Institute Junagadh685 (Id: C45262),Junagadh,Technical/Polytechnic,666,14,680,28,11,39,1,1,17.44,12.48
206,Gujarat,Gujarat Technological University Ahmedbabd (Id: U0135),A. R. COLLEGE OF PHARMACY and G.H.P. INSTITUTE OF PHARMACY(Diploma) V.V.0GAR 401 (Id: C460),Anand,Technical/Polytechnic,0,0,0,0,0,0,0,0,0,0
207,Gujarat,Gujarat Technological University Ahmedbabd (Id: U0135),Arpit Institute of Engineering and Technology (Diploma)HadalaRajkot 680 (Id: C220),Rajkot,Technical/Polytechnic,1004,27,1031,38,14,52,0,1,19.83,9.95
208,Gujarat,Gujarat Technological University Ahmedbabd (Id: U0135),ARRDEKTA INSTITUTE OF TECHNOLOGY696 (Id: C48752),Sabar Kantha,Technical/Polytechnic,0,0,0,0,0,0,1,0,0,3.34
209,Gujarat,Gujarat Technological University Ahmedbabd (Id: U0135),ASIAN INSTITUTE OF TECHNOLOGY VADALI (969) (Id: C50517),Sabar Kantha,Technical/Polytechnic,0,0,0,0,0,0,0,0,0,0
210,Gujarat,Gujarat Technological University Ahmedbabd (Id: U0135),ASIATIC INSTITUTE OF SCIENCE AND TECHNOLOGY978 (Id: C49607),Rajkot,Technical/Polytechnic,0,0,0,0,0,0,1,1,0,6.67
211,Gujarat,Gujarat Technological University Ahmedbabd (Id: U0135),Atmiya institue of Technology and Science for Diploma Studies Yogi Devine Soc Rajkot 603 (Id: C61),Rajkot,Technical/Polytechnic,1419,254,1673,64,23,87,1,1,19.23,13.08
212,Gujarat,Gujarat Technological University Ahmedbabd (Id: U0135),ATMIYA INSTITUTE KHADIYA (Id: C45262),Junagadh,Technical/Polytechnic,666,14,680,28,11,39,0,0,17.44,5.82
213,Gujarat,Gujarat Technological University Ahmedbabd (Id: U0135),Atul Polytechnic Mansa Mahudi 664 (Id: C203),Gandhinagar,Technical/Polytechnic,1240,78,1318,69,21,90,1,1,14.65,11.55
214,Gujarat,Gujarat Technological University Ahmedbabd (Id: U0135),A.V.Parekh Technical InstituteRajkot 602 (Id: C50),Rajkot,Technical/Polytechnic,1429,692,2121,42,22,64,1,1,33.15,17.72
215,Gujarat,Gujarat Technological University Ahmedbabd (Id: U0135),A. Y. Dadabhai Technical Institute Kosamba 601 (Id: C364),Surat,Technical/Polytechnic,1014,134,1148,39,16,55,0,0,20.88,6.96
216,Gujarat,Gujarat Technological University Ahmedbabd (Id: U0135),Balaji Insti. Of Eng. and Tech Junagadh 663 (Id: C265),Junagadh,Technical/Polytechnic,903,122,1025,49,8,57,1,1,17.99,12.67
217,Gujarat,Gujarat Technological University Ahmedbabd (Id: U0135),Balasinor College of Polytechnic Dist. Kheda 678 (Id: C238),Kheda,Technical/Polytechnic,880,44,924,31,7,38,0,1,24.32,11.44
218,Gujarat,Gujarat Technological University Ahmedbabd (Id: U0135),B and B Institute of TechnologyVallabh Vidhyanagar  GIA 604 (Id: C166),Anand,Technical/Polytechnic,837,293,1130,46,6,52,1,1,21.74,13.92
219,Gujarat,Gujarat Technological University Ahmedbabd (Id: U0135),B and B Institute of TechnologyVallabh Vidhyanagar (SFI) 605 (Id: C422),Anand,Technical/Polytechnic,541,151,692,22,7,29,1,0,23.87,11.29
220,Gujarat,Gujarat Technological University Ahmedbabd (Id: U0135),Bhagvan Mahavir Polytechnic Surat 608 (Id: C78),Surat,Technical/Polytechnic,831,192,1023,54,25,79,1,0,12.95,7.65
221,Gujarat,Gujarat Technological University Ahmedbabd (Id: U0135),B.S.Patel PolytechnicMehsana. 644 (Id: C200),Mahesana,Technical/Polytechnic,3298,346,3644,291,33,324,1,1,11.25,10.42
222,Gujarat,Gujarat Technological University Ahmedbabd (Id: U0135),Butler Polytechnic Vadodara 606 (Id: C59),Vadodara,Technical/Polytechnic,456,94,550,16,11,27,1,1,20.38,13.46
223,Gujarat,Gujarat Technological University Ahmedbabd (Id: U0135),Christ Polytechnic Institute Rajkot 610 (Id: C32),Rajkot,Technical/Polytechnic,1696,133,1829,56,40,96,1,1,19.06,13.02
224,Gujarat,Gujarat Technological University Ahmedbabd (Id: U0135),C.U.Shah PolytechnicSurendranagar 609 (Id: C349),Surendranagar,Technical/Polytechnic,1245,273,1518,70,19,89,1,0,17.06,9.02
225,Gujarat,Gujarat Technological University Ahmedbabd (Id: U0135),D.A. Diploma Engg. and Technology Mahemdavad 682 (Id: C177),Kheda,Technical/Polytechnic,991,70,1061,38,11,49,1,1,21.66,13.89
226,Gujarat,Gujarat Technological University Ahmedbabd (Id: U0135),Dalia Insti. Of Diploma Studies (667 )Kheda (Id: C424),Kheda,Technical/Polytechnic,1278,92,1370,53,10,63,1,1,21.75,13.92
227,Gujarat,Gujarat Technological University Ahmedbabd (Id: U0135),Dalia Insti. Of Diploma Studies Kheda 667 (Id: C424),Kheda,Technical/Polytechnic,1278,92,1370,53,10,63,0,0,21.75,7.25
228,Gujarat,Gujarat Technological University Ahmedbabd (Id: U0135),Darshan Inst. Of Eng. and Tech. For Diploma Studies Rajkot 662 (Id: C232),Rajkot,Technical/Polytechnic,414,30,444,65,7,72,1,0,6.17,5.39
229,Gujarat,Gujarat Technological University Ahmedbabd (Id: U0135),Dr. Dayaram Patel Pharmacy College (Diploma) Bardoli Surat 406 (Id: C459),Surat,Technical/Polytechnic,18,26,44,2,2,4,0,0,11,3.67
230,Gujarat,Gujarat Technological University Ahmedbabd (Id: U0135),Dr.J.N.Maheta Government PolytechnicAmreli 611 (Id: C287),Amreli,Technical/Polytechnic,1434,250,1684,43,3,46,0,0,36.61,12.21
231,Gujarat,Gujarat Technological University Ahmedbabd (Id: U0135),DR 0TUBHAI POLYTECHNIC MAHESA0 (Id: C50672),Mahesana,Technical/Polytechnic,0,0,0,0,0,0,0,0,0,0
232,Gujarat,Gujarat Technological University Ahmedbabd (Id: U0135),Dr.S.and S.S.Gandhi college of Engg. And TechnologySurat 612 (Id: C248),Surat,Technical/Polytechnic,2396,248,2644,72,25,97,0,0,27.26,9.09
233,Gujarat,Gujarat Technological University Ahmedbabd (Id: U0135),DR. SUBHASH TECHNICAL CAMPUS (695) (Id: C47844),Junagadh,Technical/Polytechnic,0,0,0,0,0,0,0,1,0,3.34
234,Gujarat,Gujarat Technological University Ahmedbabd (Id: U0135),ENGINEERING COLLEGE TUWA DIPLOMA SECOND SHIFT  958 (Id: C48517),Panch Mahals,Technical/Polytechnic,0,0,0,0,0,0,1,1,0,6.67
235,Gujarat,Gujarat Technological University Ahmedbabd (Id: U0135),Excel Institute of Diploma StudiesKalol 613 (Id: C297),Gandhinagar,Technical/Polytechnic,528,36,564,39,17,56,0,1,10.08,6.7
236,Gujarat,Gujarat Technological University Ahmedbabd (Id: U0135),F. D.(Mubin) Institute of Engineering and Technology Dehgam Bahiyal Gandhinagar 675 (Id: C328),Gandhinagar,Technical/Polytechnic,680,38,718,36,4,40,0,0,17.95,5.99
237,Gujarat,Gujarat Technological University Ahmedbabd (Id: U0135),Government Girls PolytechnicAhmedabad 614 (Id: C29),Ahmadabad,Technical/Polytechnic,0,1801,1801,20,48,68,1,1,26.49,15.5
238,Gujarat,Gujarat Technological University Ahmedbabd (Id: U0135),Government Girls PolytechnicSurat. 615 (Id: C385),Surat,Technical/Polytechnic,0,1744,1744,30,25,55,0,1,31.71,13.91
239,Gujarat,Gujarat Technological University Ahmedbabd (Id: U0135),Government Polytechnic AahvaDang 616 (Id: C387),The Dangs,Technical/Polytechnic,378,66,444,21,2,23,1,1,19.31,13.11
240,Gujarat,Gujarat Technological University Ahmedbabd (Id: U0135),Government Polytechnic Ahmedabad 617 (Id: C351),Ahmadabad,Technical/Polytechnic,0,0,0,0,0,0,1,1,0,6.67
241,Gujarat,Gujarat Technological University Ahmedbabd (Id: U0135),Government PolytechnicBhuj 621 (Id: C56),Kachchh,Technical/Polytechnic,1986,92,2078,32,9,41,0,0,50.69,16.9
242,Gujarat,Gujarat Technological University Ahmedbabd (Id: U0135),Government PolytechnicChotta Udepur 622 (Id: C277),Vadodara,Technical/Polytechnic,1214,37,1251,43,2,45,0,0,27.8,9.27
243,Gujarat,Gujarat Technological University Ahmedbabd (Id: U0135),Government PolytechnicDahod 630 (Id: C217),Dohad,Technical/Polytechnic,1266,263,1529,67,12,79,1,1,19.36,13.12
244,Gujarat,Gujarat Technological University Ahmedbabd (Id: U0135),Government PolytechnicGandhinagar (Id: C237),Gandhinagar,Technical/Polytechnic,2472,971,3443,57,33,90,1,1,38.26,19.42
245,Gujarat,Gujarat Technological University Ahmedbabd (Id: U0135),Government PolytechnicGandhinagar 623 (Id: C237),Gandhinagar,Technical/Polytechnic,2472,971,3443,57,33,90,1,0,38.26,16.09
246,Gujarat,Gujarat Technological University Ahmedbabd (Id: U0135),Government Polytechnic Godhra 618 (Id: C357),Panch Mahals,Technical/Polytechnic,932,57,989,31,2,33,0,1,29.97,13.33
247,Gujarat,Gujarat Technological University Ahmedbabd (Id: U0135),Government PolytechnicHimmatnagar 624 (Id: C337),Sabar Kantha,Technical/Polytechnic,1621,376,1997,28,20,48,1,0,41.61,17.21
248,Gujarat,Gujarat Technological University Ahmedbabd (Id: U0135),Government PolytechnicJamnagar 625 (Id: C51),Jamnagar,Technical/Polytechnic,1366,326,1692,55,22,77,0,0,21.98,7.33
249,Gujarat,Gujarat Technological University Ahmedbabd (Id: U0135),Government Polytechnic Junagadh 619 (Id: C369),Jamnagar,Technical/Polytechnic,431,50,481,25,4,29,0,0,16.59,5.53
250,Gujarat,Gujarat Technological University Ahmedbabd (Id: U0135),GOVERNMENT POLYTECHNIC KHEDA  972 (Id: C48522),Kheda,Technical/Polytechnic,0,0,0,0,0,0,0,1,0,3.34
251,Gujarat,Gujarat Technological University Ahmedbabd (Id: U0135),GOVERNMENT POLYTECHNIC 0VSARI 975 (Id: C48476),Navsari,Technical/Polytechnic,0,0,0,0,0,0,0,0,0,0
252,Gujarat,Gujarat Technological University Ahmedbabd (Id: U0135),Government PolytechnicPalanpur 626 (Id: C416),Banas Kantha,Technical/Polytechnic,2006,149,2155,73,12,85,1,0,25.36,11.79
253,Gujarat,Gujarat Technological University Ahmedbabd (Id: U0135),Government PolytechnicPorbandar 627 (Id: C279),Porbandar,Technical/Polytechnic,1268,328,1596,44,14,58,0,1,27.52,12.51
254,Gujarat,Gujarat Technological University Ahmedbabd (Id: U0135),Government Polytechnic Rajkot 620 (Id: C243),Rajkot,Technical/Polytechnic,2900,310,3210,101,21,122,0,0,26.32,8.78
255,Gujarat,Gujarat Technological University Ahmedbabd (Id: U0135),GOVERNMENT POLYTECHNIC Rajpipla  973 (Id: C48523),Bharuch,Technical/Polytechnic,0,0,0,0,0,0,1,0,0,3.34
256,Gujarat,Gujarat Technological University Ahmedbabd (Id: U0135),Government PolytechnicVadnagar 628 (Id: C187),Mahesana,Technical/Polytechnic,372,66,438,18,10,28,1,1,15.65,11.89
257,Gujarat,Gujarat Technological University Ahmedbabd (Id: U0135),Government PolytechnicVadnagar 628 (Id: C187),Patan,Technical/Polytechnic,372,66,438,18,10,28,0,0,15.65,5.22
258,Gujarat,Gujarat Technological University Ahmedbabd (Id: U0135),Government PolytechnicValsad 629 (Id: C300),Valsad,Technical/Polytechnic,2103,238,2341,49,13,62,1,1,37.76,19.26
259,Gujarat,Gujarat Technological University Ahmedbabd (Id: U0135),GOVERNMENT POLYTECHNIC VYARA 974 (Id: C48673),Surat,Technical/Polytechnic,0,0,0,0,0,0,0,1,0,3.34
260,Gujarat,Gujarat Technological University Ahmedbabd (Id: U0135),GROW MORE FACULTY OF DIPLOMA ENGINEERING684 (Id: C48759),Sabar Kantha,Technical/Polytechnic,0,0,0,0,0,0,0,0,0,0
261,Gujarat,Gujarat Technological University Ahmedbabd (Id: U0135),GUJARAT INSTITUTE OF TECHNICAL STUDIES  967 (Id: C48581),Sabar Kantha,Technical/Polytechnic,0,0,0,0,0,0,1,1,0,6.67
262,Gujarat,Gujarat Technological University Ahmedbabd (Id: U0135),H. B. Patel Institute of Diploma Engineering and Technology (676)Limbodara Lunavada (Id: C184),Gandhinagar,Technical/Polytechnic,805,43,848,26,1,27,0,1,31.41,13.81
263,Gujarat,Gujarat Technological University Ahmedbabd (Id: U0135),H. B. Patel Institute of Diploma Engineering and Technology Limbodara Lunavada 676 (Id: C184),Gandhinagar,Technical/Polytechnic,805,43,848,26,1,27,1,0,31.41,13.81
264,Gujarat,Gujarat Technological University Ahmedbabd (Id: U0135),HJD INSTITUTE OF TECHNICAL EDUCATION AND RESEARCH968 (Id: C48649),Kachchh,Technical/Polytechnic,0,0,0,0,0,0,0,0,0,0
265,Gujarat,Gujarat Technological University Ahmedbabd (Id: U0135),Image Engg. And Technology Institute Kheda 683 (Id: C205),Kheda,Technical/Polytechnic,752,19,771,46,11,57,1,0,13.53,7.85
266,Gujarat,Gujarat Technological University Ahmedbabd (Id: U0135),IPCOWALA INSTITUTE OF ENGINEERING AND TECHNOLOGY951 (Id: C49600),Anand,Technical/Polytechnic,0,0,0,0,0,0,1,0,0,3.34
267,Gujarat,Gujarat Technological University Ahmedbabd (Id: U0135),JASHODABA POLYTECHNIC INSTITUTE SIDHPUR (Id: C47930),Patan,Technical/Polytechnic,217,4,221,6,3,9,0,1,24.56,11.52
268,Gujarat,Gujarat Technological University Ahmedbabd (Id: U0135),JASHODABA POLYTECHNIC INSTITUTE  SIDHPUR 952 (Id: C47930),Patan,Technical/Polytechnic,217,4,221,6,3,9,1,0,24.56,11.52
269,Gujarat,Gujarat Technological University Ahmedbabd (Id: U0135),JAYVANTRAI HARRAI DESAI POLYTECHNIC PALSA0 (Id: C45264),Surat,Technical/Polytechnic,526,44,570,29,4,33,0,1,17.28,9.1
270,Gujarat,Gujarat Technological University Ahmedbabd (Id: U0135),JAYVANTRAI HARRAI DESAI POLYTECHNIC PALSA0 686 (Id: C45264),Surat,Technical/Polytechnic,526,44,570,29,4,33,0,0,17.28,5.76
271,Gujarat,Gujarat Technological University Ahmedbabd (Id: U0135),J.J.C.E. Trust Sanchalit N.R.Vekaria Insti. Of Tech.  Junagadh 679 (Id: C126),Junagadh,Technical/Polytechnic,282,30,312,17,12,29,0,1,10.76,6.92
272,Gujarat,Gujarat Technological University Ahmedbabd (Id: U0135),K.D.PolytechnicPatan 631 (Id: C156),Patan,Technical/Polytechnic,2026,377,2403,74,18,92,0,1,26.12,12.04
273,Gujarat,Gujarat Technological University Ahmedbabd (Id: U0135),K J INSTITUTE OF ENGINEERING AND TECHNOLOGY957 (Id: C48651),Vadodara,Technical/Polytechnic,0,0,0,0,0,0,1,1,0,6.67
274,Gujarat,Gujarat Technological University Ahmedbabd (Id: U0135),K.P.Thakkar Swa. Krishanajeevandas Insti of TechSokli 632 (Id: C21),Ahmadabad,Technical/Polytechnic,1199,43,1242,29,7,36,0,1,34.5,14.84
275,Gujarat,Gujarat Technological University Ahmedbabd (Id: U0135),Lakhdhirji Enggniering collegeMorbi. 031 (Id: C191),Rajkot,Technical/Polytechnic,1406,155,1561,50,12,62,1,1,25.18,15.06
276,Gujarat,Gujarat Technological University Ahmedbabd (Id: U0135),LAXMI INSTITUTE OF TECHNOLOGY SARIGAM (2ND SHIFT) 691 (Id: C47849),Valsad,Technical/Polytechnic,0,0,0,0,0,0,1,0,0,3.34
277,Gujarat,Gujarat Technological University Ahmedbabd (Id: U0135),LEADS INTSTITUTE OF TECHNOLOGY AND ENGINEERING964 (Id: C48648),Bharuch,Technical/Polytechnic,0,0,0,0,0,0,0,0,0,0
278,Gujarat,Gujarat Technological University Ahmedbabd (Id: U0135),L.J.PolytechnicAhmedabad 633 (Id: C95),Ahmadabad,Technical/Polytechnic,0,0,0,0,0,0,1,0,0,3.34
279,Gujarat,Gujarat Technological University Ahmedbabd (Id: U0135),L. M. College Of Pharmacy (Diploma) 408 (Id: C458),Ahmadabad,Technical/Polytechnic,44,45,89,4,5,9,1,1,9.89,9.97
280,Gujarat,Gujarat Technological University Ahmedbabd (Id: U0135),MAHAVIR SWAMI COLLEGE OF POLYTECHNIC  955 (Id: C48582),Surat,Technical/Polytechnic,0,0,0,0,0,0,0,0,0,0
281,Gujarat,Gujarat Technological University Ahmedbabd (Id: U0135),Merchant Polytechnic Visnagar 636 (Id: C240),Mahesana,Technical/Polytechnic,1451,86,1537,70,17,87,0,1,17.67,9.23
282,Gujarat,Gujarat Technological University Ahmedbabd (Id: U0135),M.L.Institute of Diploma Studies Bhandu 635 (Id: C226),Mahesana,Technical/Polytechnic,0,0,0,0,0,0,0,1,0,3.34
283,Gujarat,Gujarat Technological University Ahmedbabd (Id: U0135),M. N. College Of Pharmacy (Diploma) Khambhat 409 (Id: C457),Anand,Technical/Polytechnic,61,33,94,5,1,6,0,1,15.67,8.56
284,Gujarat,Gujarat Technological University Ahmedbabd (Id: U0135),Narayanbhai Bhikhabhai Patel PolytechnicPiludara Mehsana 668 (Id: C215),Mahesana,Technical/Polytechnic,1233,43,1276,44,7,51,1,1,25.02,15.01
285,Gujarat,Gujarat Technological University Ahmedbabd (Id: U0135),0VSARJAN POLYTECHNIC RAMPUR KUWAIDA (Id: C45265),Mahesana,Technical/Polytechnic,629,14,643,26,11,37,0,1,17.38,9.13
286,Gujarat,Gujarat Technological University Ahmedbabd (Id: U0135),0VSARJAN POLYTECHNIC RAMPUR KUWAIDA 687 (Id: C45265),Mahesana,Technical/Polytechnic,629,14,643,26,11,37,0,1,17.38,9.13
287,Gujarat,Gujarat Technological University Ahmedbabd (Id: U0135),0VSARJAN SCHOOL OF TECHNOLOGY960 (Id: C49604),Gandhinagar,Technical/Polytechnic,0,0,0,0,0,0,1,1,0,6.67
288,Gujarat,Gujarat Technological University Ahmedbabd (Id: U0135),N.G.Patel PolytechnicIsroli 637 (Id: C268),Surat,Technical/Polytechnic,1234,178,1412,61,11,72,1,0,19.62,9.88
289,Gujarat,Gujarat Technological University Ahmedbabd (Id: U0135),NOBLE DIPLOMA ENGINEERING COLLEGE  692 (Id: C48518),Junagadh,Technical/Polytechnic,0,0,0,0,0,0,0,0,0,0
290,Gujarat,Gujarat Technological University Ahmedbabd (Id: U0135),Om Insti. Of Eng.and Technology Junagadh 665 (Id: C210),Junagadh,Technical/Polytechnic,788,88,876,42,11,53,1,0,16.53,8.85
291,Gujarat,Gujarat Technological University Ahmedbabd (Id: U0135),Omshanti Diploma Engg Rajkot 672 (Id: C353),Rajkot,Technical/Polytechnic,0,0,0,0,0,0,1,0,0,3.34
292,Gujarat,Gujarat Technological University Ahmedbabd (Id: U0135),Pacific School of Engineering 976 (Id: C48516),Surat,Technical/Polytechnic,0,0,0,0,0,0,1,0,0,3.34
293,Gujarat,Gujarat Technological University Ahmedbabd (Id: U0135),PACIFIC SCHOOL OF ENGINEERING  976 (Id: C48516),Surat,Technical/Polytechnic,0,0,0,0,0,0,0,0,0,0
294,Gujarat,Gujarat Technological University Ahmedbabd (Id: U0135),Parul Institute of Diploma Studies 638 (Id: C81),Vadodara,Technical/Polytechnic,3457,604,4061,132,73,205,0,0,19.81,6.61
295,Gujarat,Gujarat Technological University Ahmedbabd (Id: U0135),Parul Institute of Diploma StudiesLimda 639 (Id: C157),Vadodara,Technical/Polytechnic,1233,371,1604,44,50,94,1,1,17.07,12.36
296,Gujarat,Gujarat Technological University Ahmedbabd (Id: U0135),RADHE INSTITUTE OF ENGINEERING AND TECHNOLOGY UPLETA970 (Id: C50653),Rajkot,Technical/Polytechnic,0,0,0,0,0,0,1,1,0,6.67
297,Gujarat,Gujarat Technological University Ahmedbabd (Id: U0135),R.C.Technical InstituteAhmedabad 640 (Id: C206),Ahmadabad,Technical/Polytechnic,2150,443,2593,92,29,121,0,0,21.43,7.15
298,Gujarat,Gujarat Technological University Ahmedbabd (Id: U0135),R.H.PATEL INSTI. OF TECHNOLOGYGOBLAJKHEDA 641 (Id: C27),Kheda,Technical/Polytechnic,326,3,329,96,12,108,0,0,3.05,1.02
299,Gujarat,Gujarat Technological University Ahmedbabd (Id: U0135),RMS Polytechnic Waghodiya 642 (Id: C403),Vadodara,Technical/Polytechnic,2275,133,2408,99,27,126,0,0,19.12,6.38
300,Gujarat,Gujarat Technological University Ahmedbabd (Id: U0135),SANSKAR INSTITUTE OF TECHNOLOGY (953) (Id: C47850),Vadodara,Technical/Polytechnic,203,6,209,16,0,16,0,1,13.07,7.69
301,Gujarat,Gujarat Technological University Ahmedbabd (Id: U0135),Sarvodaya Polytechnic Institute Limbdi 643 (Id: C158),Surendranagar,Technical/Polytechnic,1140,31,1171,49,7,56,1,0,20.92,10.31
302,Gujarat,Gujarat Technological University Ahmedbabd (Id: U0135),Savitaben Dahyabhai Patel Polytechnic Mehsana 669 (Id: C374),Mahesana,Technical/Polytechnic,1027,26,1053,42,8,50,1,0,21.06,10.36
303,Gujarat,Gujarat Technological University Ahmedbabd (Id: U0135),S.B. Polytechnic Savli Vadodara 666 (Id: C77),Vadodara,Technical/Polytechnic,1209,132,1341,39,28,67,0,1,20.02,10.01
304,Gujarat,Gujarat Technological University Ahmedbabd (Id: U0135),Shantilal Shah Pharmacy College (Diploma) 414 (Id: C463),Bhavnagar,Technical/Polytechnic,31,18,49,5,1,6,0,1,8.17,6.06
305,Gujarat,Gujarat Technological University Ahmedbabd (Id: U0135),SHREE DHANVANTARY COLLEGE OF DIPLOMA ENGINEERING981 (Id: C48650),Surat,Technical/Polytechnic,0,0,0,0,0,0,1,0,0,3.34
306,Gujarat,Gujarat Technological University Ahmedbabd (Id: U0135),Shree Hari Polytechnic Institute Nani Kadi 677 (Id: C71),Mahesana,Technical/Polytechnic,1105,44,1149,47,11,58,1,1,19.82,13.28
307,Gujarat,Gujarat Technological University Ahmedbabd (Id: U0135),SHREE H N SHUKLA DIPLOMA ENGINEERING COLLEGE  980 (Id: C48580),Rajkot,Technical/Polytechnic,0,0,0,0,0,0,0,1,0,3.34
308,Gujarat,Gujarat Technological University Ahmedbabd (Id: U0135),SHREE PANDIT 0THULALJI VYAS TECHNICAL CAMPUS  962 (Id: C48584),Surendranagar,Technical/Polytechnic,0,0,0,0,0,0,1,0,0,3.34
309,Gujarat,Gujarat Technological University Ahmedbabd (Id: U0135),SHREE SWAMI0RAYAN POLYTECHNIC (Id: C50210),Gandhinagar,Technical/Polytechnic,0,0,0,0,0,0,0,1,0,3.34
310,Gujarat,Gujarat Technological University Ahmedbabd (Id: U0135),SHREE VASUDEVBHAI AND KANTILAL PATEL INSTITUTE OF ENGINEERING 971 (Id: C48475),Mahesana,Technical/Polytechnic,0,0,0,0,0,0,1,1,0,6.67
311,Gujarat,Gujarat Technological University Ahmedbabd (Id: U0135),Shri B. M. Shah College Of Pharmacy (Diploma) Modasa 415 (Id: C464),Sabar Kantha,Technical/Polytechnic,11,12,23,4,1,5,0,1,4.6,4.87
312,Gujarat,Gujarat Technological University Ahmedbabd (Id: U0135),SHRI J M SABVA INSTITUTE OF ENGINEERING AND TECHNOLOGY 698 (Id: C48668),Bhavnagar,Technical/Polytechnic,0,0,0,0,0,0,0,1,0,3.34
313,Gujarat,Gujarat Technological University Ahmedbabd (Id: U0135),Shri K.J.Polytechnic(645)Bharuch (Id: C318),Bharuch,Technical/Polytechnic,2395,680,3075,43,33,76,1,0,40.47,16.83
314,Gujarat,Gujarat Technological University Ahmedbabd (Id: U0135),Shri K.J.PolytechnicBharuch 645 (Id: C318),Bharuch,Technical/Polytechnic,2395,680,3075,43,33,76,0,1,40.47,16.83
315,Gujarat,Gujarat Technological University Ahmedbabd (Id: U0135),SHRI LABHUBHAI TRIVEDI INSTITUTE OF ENGINEERING AND TECHNOLOGY  954 (Id: C48515),Rajkot,Technical/Polytechnic,0,0,0,0,0,0,0,1,0,3.34
316,Gujarat,Gujarat Technological University Ahmedbabd (Id: U0135),Shri N.M.Gopani Polytechnic instituteRanpur 646 (Id: C255),Ahmadabad,Technical/Polytechnic,2021,25,2046,88,10,98,1,1,20.88,13.63
317,Gujarat,Gujarat Technological University Ahmedbabd (Id: U0135),SHRI SATSANGI SAKETDHAM RAM ASRAM GROUP OF INSTITUTIONS 690 (Id: C48670),Mahesana,Technical/Polytechnic,0,0,0,0,0,0,0,0,0,0
318,Gujarat,Gujarat Technological University Ahmedbabd (Id: U0135),Shri Tapi Brahmcharyashram sabha college of Diploma EnggSurat. 647 (Id: C23),Surat,Technical/Polytechnic,1147,259,1406,48,17,65,1,0,21.64,10.55
319,Gujarat,Gujarat Technological University Ahmedbabd (Id: U0135),Sigma Institute of Technology and Engg.( Polytechnic) 648 (Id: C289),Vadodara,Technical/Polytechnic,0,0,0,0,0,0,1,1,0,6.67
320,Gujarat,Gujarat Technological University Ahmedbabd (Id: U0135),Sir Bhavsinhji Polytechnic Institute Bhavnagar 649 (Id: C288),Bhavnagar,Technical/Polytechnic,2696,436,3132,60,22,82,0,1,38.2,16.07
321,Gujarat,Gujarat Technological University Ahmedbabd (Id: U0135),Smt. R.S.Patel Insti. Of Diploma Engg. Shelavi Patan 681 (Id: C54),Patan,Technical/Polytechnic,201,10,211,38,3,41,1,0,5.15,5.05
322,Gujarat,Gujarat Technological University Ahmedbabd (Id: U0135),S P B PATEL ENGINEERING COLLEGE (DIPLOMA COURSE)  693 (Id: C48579),Mahesana,Technical/Polytechnic,0,0,0,0,0,0,1,0,0,3.34
323,Gujarat,Gujarat Technological University Ahmedbabd (Id: U0135),SURAJ MUCHHALA POLYTECHNIC 977 (Id: C48672),Rajkot,Technical/Polytechnic,0,0,0,0,0,0,1,0,0,3.34
324,Gujarat,Gujarat Technological University Ahmedbabd (Id: U0135),Swaminarayan College of Engg. Saij Kalol 671 (Id: C363),Gandhinagar,Technical/Polytechnic,1016,122,1138,49,21,70,0,0,16.26,5.42
325,Gujarat,Gujarat Technological University Ahmedbabd (Id: U0135),Swami Sacchidanand Polytechnic collegeVisnagar 650 (Id: C252),Mahesana,Technical/Polytechnic,1614,147,1761,93,17,110,1,1,16.01,12.01
326,Gujarat,Gujarat Technological University Ahmedbabd (Id: U0135),TATVA INSTITUTE OF TECHNOLOGICAL STUDIES689 (Id: C48751),Sabar Kantha,Technical/Polytechnic,0,0,0,0,0,0,0,0,0,0
327,Gujarat,Gujarat Technological University Ahmedbabd (Id: U0135),T.F.Gandhidham PolytechnicAdipur(Kutch) 651 (Id: C428),Kachchh,Technical/Polytechnic,418,59,477,23,3,26,0,0,18.35,6.12
328,Gujarat,Gujarat Technological University Ahmedbabd (Id: U0135),Tolani FoundationGandhidham Polytechnic(SFI) 653 (Id: C223),Kachchh,Technical/Polytechnic,590,91,681,21,11,32,1,0,21.29,10.43
329,Gujarat,Gujarat Technological University Ahmedbabd (Id: U0135),Tolani Institute Of Pharmacy (Diploma) Adipur 417 (Id: C465),Kachchh,Technical/Polytechnic,25,14,39,1,3,4,1,1,9.75,9.92
330,Gujarat,Gujarat Technological University Ahmedbabd (Id: U0135),VALIA POLYTECHNIC COLLEGE (Id: C45258),Bharuch,Technical/Polytechnic,596,4,600,25,6,31,0,0,19.36,6.46
331,Gujarat,Gujarat Technological University Ahmedbabd (Id: U0135),VALIA POLYTECHNIC COLLEGE 688 (Id: C45258),Bharuch,Technical/Polytechnic,596,4,600,25,6,31,1,0,19.36,9.79
332,Gujarat,Gujarat Technological University Ahmedbabd (Id: U0135),Vallabhbudhi polytechnic Navsari 655 (Id: C420),Navsari,Technical/Polytechnic,1454,265,1719,62,29,91,0,0,18.9,6.3
333,Gujarat,Gujarat Technological University Ahmedbabd (Id: U0135),Ved Vyas Polytechnic Himmatnagar 661 (Id: C293),Sabar Kantha,Technical/Polytechnic,1068,62,1130,32,10,42,1,0,26.91,12.31
334,Gujarat,Gujarat Technological University Ahmedbabd (Id: U0135),VEERAYATAN GROUP OF INSTITUTIONS FACULTY OF ENGG (697) (Id: C47847),Kachchh,Technical/Polytechnic,0,0,0,0,0,0,0,1,0,3.34
335,Gujarat,Gujarat Technological University Ahmedbabd (Id: U0135),Verdhman Bharti Trust Technical Institute Of Diploma Studies Wadhwan City 652 (Id: C325),Surendranagar,Technical/Polytechnic,1049,73,1122,31,16,47,1,0,23.88,11.3
336,Gujarat,Gujarat Technological University Ahmedbabd (Id: U0135),Vidhyabharti Trust Polytechnic InstituteUmrakh. (Id: C31),Junagadh,Technical/Polytechnic,1264,133,1397,53,13,66,1,0,21.17,10.39
337,Gujarat,Gujarat Technological University Ahmedbabd (Id: U0135),Vidhyabharti Trust Polytechnic InstituteUmrakh. 656 (Id: C31),Surat,Technical/Polytechnic,1264,133,1397,53,13,66,0,0,21.17,7.06
338,Gujarat,Gujarat Technological University Ahmedbabd (Id: U0135),VIDHYADEEP INSTITUTE OF MA0GEMENT and TECHNOLOGY  963 (Id: C48583),Surat,Technical/Polytechnic,0,0,0,0,0,0,1,0,0,3.34
339,Gujarat,Gujarat Technological University Ahmedbabd (Id: U0135),V.P.M.P. Polytechnic Gandhinagar 654 (Id: C283),Gandhinagar,Technical/Polytechnic,1718,333,2051,62,32,94,1,0,21.82,10.61
340,Gujarat,Gujarat University Ahmedabad (Id: U0136),B. M. Institute of Mental Health (Id: C5800),Ahmadabad,Teacher Training,26,14,40,3,0,3,1,1,13.34,11.12
341,Gujarat,Gujarat University Ahmedabad (Id: U0136),DR B R AMBEDKAR COLLEGE OF NURSING (Id: C47897),Gandhinagar,Nursing,42,147,189,8,12,20,1,1,9.45,9.82
342,Gujarat,Gujarat University Ahmedabad (Id: U0136),G. L. S. (J. P. Shah) Institute of Business Administration (Id: C6071),Ahmadabad,Technical/Polytechnic,430,277,707,2,8,10,1,0,70.7,26.9
343,Gujarat,Gujarat University Ahmedabad (Id: U0136),MUNI SEVA ASHRAM COLLEGE OF NURSING (Id: C47908),Panch Mahals,Nursing,1,3,4,3,2,5,1,1,0.8,6.94
344,Gujarat,Gujarat University Ahmedabad (Id: U0136),National Institute of Mass Communication and Journalism (Id: C5793),Ahmadabad,Technical/Polytechnic,0,0,0,0,0,0,0,0,0,0
345,Gujarat,Gujarat University Ahmedabad (Id: U0136),Prakash College of Education (Id: C5999),Ahmadabad,Teacher Training,0,0,0,0,0,0,1,0,0,3.34
346,Gujarat,Gujarat University Ahmedabad (Id: U0136),SHARDA NURSING COLLEGE PANSAR (Id: C47903),Gandhinagar,Nursing,15,59,74,7,14,21,0,1,3.53,4.51
347,Gujarat,Gujarat University Ahmedabad (Id: U0136),Shubham Institute of Nursing Science and Research Center (Id: C6124),Ahmadabad,Nursing,80,220,300,11,25,36,1,1,8.34,9.45
348,Gujarat,Hemchandracharya North Gujart University Patan (Id: U0138),ARVALLI COLLEGE OF COMP HIGH EDU(PGDCA) IDAR (Id: C6639),Sabar Kantha,Technical/Polytechnic,0,0,0,0,0,0,0,1,0,3.34
349,Gujarat,Hemchandracharya North Gujart University Patan (Id: U0138),BDKM BCA COLLEGE PALANPUR (Id: C6852),Banas Kantha,Technical/Polytechnic,378,221,599,9,3,12,1,0,49.92,19.98
350,Gujarat,Hemchandracharya North Gujart University Patan (Id: U0138),BHARAT EDUCATION TRUST SANCHALIT PGDCA COLLEGE (Id: C45105),Banas Kantha,Technical/Polytechnic,0,0,0,0,0,0,0,1,0,3.34
351,Gujarat,Hemchandracharya North Gujart University Patan (Id: U0138),D I PATEL INSTITUTE OF COMPUTER STUDIES PGDCA (Id: C6745),Patan,Teacher Training,0,0,0,0,0,0,0,0,0,0
352,Gujarat,Hemchandracharya North Gujart University Patan (Id: U0138),D L PATEL INSTITUTE OF PGDCA COLLEGE (Id: C49516),Sabar Kantha,Technical/Polytechnic,30,22,52,0,2,2,0,1,26,12
353,Gujarat,Hemchandracharya North Gujart University Patan (Id: U0138),DR N J SHAH PGDCA COLLEGE MODASA (Id: C46579),Sabar Kantha,Technical/Polytechnic,0,0,0,0,0,0,0,0,0,0
354,Gujarat,Hemchandracharya North Gujart University Patan (Id: U0138),GOVT NURSING COLLEGEDHARPUR (Id: C19323),Patan,Nursing,11,129,140,0,6,6,1,1,23.34,14.45
355,Gujarat,Hemchandracharya North Gujart University Patan (Id: U0138),GROWMORE INSTITUTE OF PGDCA COLLEGE BER0 (Id: C45124),Sabar Kantha,Technical/Polytechnic,0,0,0,0,0,0,1,0,0,3.34
356,Gujarat,Hemchandracharya North Gujart University Patan (Id: U0138),JIVANJYOT COLLEGE OF EDUCATION VALAM (Id: C48508),Mahesana,Teacher Training,38,46,84,4,7,11,1,0,7.64,5.88
357,Gujarat,Hemchandracharya North Gujart University Patan (Id: U0138),L N COLLEGE OF COMP and MA0GEMENT(PGDCA) (Id: C6753),Mahesana,Technical/Polytechnic,0,0,0,0,0,0,1,0,0,3.34
358,Gujarat,Hemchandracharya North Gujart University Patan (Id: U0138),MARCHANT INSTITUTE OF PG COURSES (Id: C6845),Mahesana,Technical/Polytechnic,24,21,45,4,0,4,0,0,11.25,3.75
359,Gujarat,Hemchandracharya North Gujart University Patan (Id: U0138),MED COLLEGE VIDHYA0GARI (Id: C6839),Sabar Kantha,Teacher Training,6,13,19,3,0,3,1,0,6.34,5.45
360,Gujarat,Hemchandracharya North Gujart University Patan (Id: U0138),MOTHER TERESA COLLEGE OF NURSING GOTHVA (Id: C45108),Mahesana,Nursing,1,19,20,4,17,21,1,0,0.96,3.66
361,Gujarat,Hemchandracharya North Gujart University Patan (Id: U0138),0RSINHBHAI PATEL COLLEGE OF COMPUTER STUD and MGT (Id: C6717),Mahesana,Technical/Polytechnic,950,596,1546,15,13,28,1,0,55.22,21.74
362,Gujarat,Hemchandracharya North Gujart University Patan (Id: U0138),NORTH GUJRAT EDUCATION TRUST SANCHALIT PGDCA COLL (Id: C6662),Patan,Technical/Polytechnic,0,0,0,0,0,0,0,1,0,3.34
363,Gujarat,Hemchandracharya North Gujart University Patan (Id: U0138),P and T PATEL COLLEGE OF EDUCATION (Id: C6815),Mahesana,Nursing,20,24,44,12,9,21,0,0,2.1,0.7
364,Gujarat,Hemchandracharya North Gujart University Patan (Id: U0138),RKM PGDCA TECHNICAL COLLEGE VIJAYA0GAR (Id: C6846),Sabar Kantha,Technical/Polytechnic,51,18,69,4,1,5,1,1,13.8,11.27
365,Gujarat,Hemchandracharya North Gujart University Patan (Id: U0138),S D SOLANKI BCA COLLEGE KUSKI (Id: C47444),Sabar Kantha,Technical/Polytechnic,0,0,0,0,0,0,1,0,0,3.34
366,Gujarat,Hemchandracharya North Gujart University Patan (Id: U0138),SHRI SHANKAR BED COLLEGE (Id: C6634),Patan,Teacher Training,40,56,96,3,4,7,1,1,13.72,11.24
367,Gujarat,Hemchandracharya North Gujart University Patan (Id: U0138),UTTAR PURVA GUJARAT UCHCH KELAVANI MANDAL BED COLL (Id: C6640),Mahesana,Teacher Training,14,34,48,1,3,4,1,0,12,7.34
368,Gujarat,Junagadh Agricultural University (Id: U0140),POLYTECHNIC IN AGRICULTURAL ENGINEERING TARGHADIA (Id: C50675),Rajkot,Technical/Polytechnic,0,0,0,0,0,0,1,0,0,3.34
369,Gujarat,Junagadh Agricultural University (Id: U0140),Polytechnic in Agriculture Dhari (Id: C6350),Amreli,Technical/Polytechnic,83,3,86,3,0,3,1,0,28.67,12.89
370,Gujarat,Junagadh Agricultural University (Id: U0140),Polytechnic in AgroProcessing Junagadh (Id: C6347),Junagadh,Technical/Polytechnic,55,34,89,3,0,3,1,0,29.67,13.23
371,Gujarat,Junagadh Agricultural University (Id: U0140),POLYTECHNIC IN ANIMAL HUSBANDARY JU0GADH (Id: C50674),Junagadh,Technical/Polytechnic,0,0,0,0,0,0,1,1,0,6.67
372,Gujarat,Junagadh Agricultural University (Id: U0140),Polytechnic in Home Science Amreli (Id: C6344),Amreli,Technical/Polytechnic,0,66,66,1,3,4,0,0,16.5,5.5
373,Gujarat,Junagadh Agricultural University (Id: U0140),Polytechnic in Horticulture Junagadh (Id: C6349),Junagadh,Technical/Polytechnic,62,19,81,4,0,4,0,0,20.25,6.75
374,Gujarat,Krantiguru Shyamji Krishna Verma Kachchh University Kachchh (Id: U0142),Anjar Education Society Sanchalit P.G.D.H.R.M. College (Id: C4116),Kachchh,Technical/Polytechnic,0,0,0,0,0,0,0,1,0,3.34
375,Gujarat,Krantiguru Shyamji Krishna Verma Kachchh University Kachchh (Id: U0142),ANJAR EDUCATION SOCIETY SANCHALIT PGDSPM COLLEGE (Id: C50256),Kachchh,Technical/Polytechnic,0,0,0,0,0,0,1,1,0,6.67
376,Gujarat,Krantiguru Shyamji Krishna Verma Kachchh University Kachchh (Id: U0142),Dr.H R Gajwani College of Education (Id: C4124),Kachchh,Teacher Training,9,89,98,1,6,7,1,1,14,11.34
377,Gujarat,Krantiguru Shyamji Krishna Verma Kachchh University Kachchh (Id: U0142),Shri Bhuj Mercantile CoOp Bank Charitable Trust Sanchalit Nursing College (Id: C4112),Kachchh,Nursing,43,139,182,0,18,18,1,0,10.12,6.71
378,Gujarat,Maharaja Krishnakumarsinhji Bhavnagar University (Id: U0124),Shree Sahjanand Institute of Nursing College (Id: C7179),Bhavnagar,Nursing,19,164,183,2,3,5,0,1,36.6,15.54
379,Gujarat,Maharaja Krishnakumarsinhji Bhavnagar University (Id: U0124),Shree Swaminarayan College of Education (Id: C7146),Bhavnagar,Teacher Training,40,50,90,3,4,7,0,0,12.86,4.29
380,Gujarat,Navsari Agricultural University (Id: U0145),POLYTECHNIC IN AGRICULTURAL ENGINEERING DEDIAPADA (Id: C48405),Narmada,Technical/Polytechnic,93,1,94,5,0,5,1,1,18.8,12.94
381,Gujarat,Navsari Agricultural University (Id: U0145),POLYTECHNIC IN AGRICULTURE COOPERATION BANKING AND MARKETING WAGHAI (Id: C48408),The Dangs,Technical/Polytechnic,60,18,78,4,0,4,1,0,19.5,9.84
382,Gujarat,Navsari Agricultural University (Id: U0145),POLYTECHNIC IN AGRICULTURE MAKTAMPUR (Id: C48406),Bharuch,Technical/Polytechnic,66,0,66,4,0,4,1,1,16.5,12.17
383,Gujarat,Navsari Agricultural University (Id: U0145),POLYTECHNIC IN AGRICULTURE VYARA (Id: C48407),Tapi,Technical/Polytechnic,39,9,48,5,1,6,1,0,8,6
384,Gujarat,Navsari Agricultural University (Id: U0145),POLYTECHNIC IN ANIMAL HUSBANDARY 0VSARI (Id: C48410),Navsari,Technical/Polytechnic,29,1,30,1,0,1,1,1,30,16.67
385,Gujarat,Navsari Agricultural University (Id: U0145),POLYTECHNIC IN HORTICULTURE 0VSARI (Id: C48409),Navsari,Technical/Polytechnic,57,39,96,3,2,5,1,1,19.2,13.07
386,Gujarat,Navsari Agricultural University (Id: U0145),POLYTECHNIC IN HORTICULTURE PARIA (Id: C48411),Valsad,Technical/Polytechnic,16,6,22,7,0,7,1,0,3.15,4.39
387,Gujarat,Nirma University Ahmedabad (Id: U0146),Institute of Diploma studies Nirma University (Id: C438),Ahmadabad,Technical/Polytechnic,1528,453,1981,67,61,128,1,1,15.48,11.83
388,Gujarat,R K University Rajkot (Id: U0647),School of Diploma Studies (Id: C33),Rajkot,Technical/Polytechnic,1370,113,1483,48,19,67,0,0,22.14,7.38
389,Gujarat,Sardar Patel University Vallabh Vidyanagar (Id: U0148),GH Patel Nursing School Karamsad (Id: C1216),Anand,Nursing,0,88,88,1,11,12,1,0,7.34,5.78
390,Gujarat,Sardar Patel University Vallabh Vidyanagar (Id: U0148),Smt. Pushpaben Kanaiyalal Inamdar College of Education Bakrol (Id: C1171),Anand,Teacher Training,0,0,0,0,0,0,0,1,0,3.34
391,Gujarat,Saurashtra University Rajkot (Id: U0151),0VYUG COLLEGE OF EDUCATION SUKHPUR (Id: C805),Junagadh,Teacher Training,43,57,100,6,3,9,1,0,11.12,7.04
392,Gujarat,Saurashtra University Rajkot (Id: U0151),SADAR PATEL TEL.KELVANI MANDAL MAHILA B.ED.COLLEGEJETPUR (Id: C1024),Rajkot,Teacher Training,0,0,0,0,0,0,1,1,0,6.67
393,Gujarat,Saurashtra University Rajkot (Id: U0151),SADHU VASWANI COLLEGE FOR PERAMEDICAL COURSESRAJKOT (Id: C787),Rajkot,Technical/Polytechnic,5,38,43,2,2,4,0,1,10.75,6.92
394,Gujarat,Saurashtra University Rajkot (Id: U0151),SHREE A.V.J. OZA INSTITUTE OF B.ED. COLLEGE LAKHTAR (Id: C1003),Surendranagar,Teacher Training,47,51,98,7,1,8,1,0,12.25,7.42
395,Gujarat,Saurashtra University Rajkot (Id: U0151),SHRI TEJENDRA PRASADJI B.ED. COLLEGECHARAVADA (Id: C1008),Surendranagar,Nursing,55,45,100,3,5,8,0,1,12.5,7.5
396,Gujarat,Saurashtra University Rajkot (Id: U0151),V.k.KAMDAR B.ED.COLLEGE RAJKOT (Id: C905),Rajkot,Teacher Training,36,69,105,8,2,10,1,1,10.5,10.17
397,Gujarat,Shree Somnath Sanskrit University Junagarh (Id: U0152),Borsad Kelavani Mandal (Id: C1145),Anand,Teacher Training,11,19,30,4,2,6,1,0,5,5
398,Gujarat,Shree Somnath Sanskrit University Junagarh (Id: U0152),Rutam (Id: C1127),Vadodara,Teacher Training,0,0,0,0,0,0,1,0,0,3.34
399,Gujarat,Shree Somnath Sanskrit University Junagarh (Id: U0152),Sarvajanik B. Ed. College (Id: C1106),Mahesana,Teacher Training,0,0,0,0,0,0,0,1,0,3.34
400,Gujarat,Shree Somnath Sanskrit University Junagarh (Id: U0152),Shri Bhartiya Yog Vedant Tapovan (Id: C1119),Mahesana,Teacher Training,0,0,0,0,0,0,0,0,0,0
401,Gujarat,Shree Somnath Sanskrit University Junagarh (Id: U0152),Shri Bhaskara Vaidic Astrology Center (Id: C1132),Surat,Teacher Training,0,0,0,0,0,0,1,1,0,6.67
402,Gujarat,Shree Somnath Sanskrit University Junagarh (Id: U0152),Shri Brahmachari wadi Sanskrit Pathshalal (Id: C1143),Ahmadabad,Teacher Training,0,0,0,0,0,0,1,1,0,6.67
403,Gujarat,Shree Somnath Sanskrit University Junagarh (Id: U0152),Shri K. K. Shastri Arts College (Id: C1142),Ahmadabad,Teacher Training,24,7,31,3,1,4,0,0,7.75,2.59
404,Gujarat,Shree Somnath Sanskrit University Junagarh (Id: U0152),Shri Muni Patanjali Yog Kendra (Id: C1146),Junagadh,Teacher Training,0,0,0,0,0,0,0,0,0,0
405,Gujarat,Shree Somnath Sanskrit University Junagarh (Id: U0152),Shri Narayan Ashram (Id: C1110),Surat,Teacher Training,0,0,0,0,0,0,1,0,0,3.34
406,Gujarat,Shree Somnath Sanskrit University Junagarh (Id: U0152),Shri Ram Yog Kendra (Id: C1140),Rajkot,Teacher Training,0,0,0,0,0,0,1,1,0,6.67
407,Gujarat,Shree Somnath Sanskrit University Junagarh (Id: U0152),Shri Unnatpuram Sanskrit Mahavidyalaya (Id: C1111),Junagadh,Teacher Training,0,0,0,0,0,0,0,0,0,0
408,Gujarat,Veer Narmad South Gujarat University Surat (Id: U0153),Sardar Patel B. Ed. College (English Medium) (Id: C526),Surat,Teacher Training,17,83,100,4,5,9,0,1,11.12,7.04
409,Gujarat,Veer Narmad South Gujarat University Surat (Id: U0153),The South Gujarat Institute of Medical Sciences (PGDMLT) (Id: C670),Navsari,Technical/Polytechnic,0,21,21,1,1,2,1,0,10.5,6.84
410,Haryana,Ch. Devi Lal University Sirsa (Id: U0160),Mata Harki Devi College of Education for Women VillOdhan (Id: C22417),Sirsa,Teacher Training,0,198,198,7,10,17,0,1,11.65,7.22
411,Haryana,Ch. Devi Lal University Sirsa (Id: U0160),Shaheed Baba Deep Singh College of Education Vill. Aharwan Ratia (Id: C22433),Fatehabad,Teacher Training,67,131,198,4,8,12,0,0,16.5,5.5
412,Haryana,Ch. Devi Lal University Sirsa (Id: U0160),Surya College of Education Vill. Baliala Tohana (Id: C22425),Fatehabad,Teacher Training,0,0,0,0,0,0,1,0,0,3.34
413,Haryana,Ch. Devi Lal University Sirsa (Id: U0160),Tirupati College of Education Sardulgarh Road Ratia (Id: C22451),Fatehabad,Teacher Training,148,149,297,10,13,23,0,0,12.92,4.31
414,Haryana,Kurukshetra University Kurukshetra (Id: U0164),Aakash College of Education Hisar (Id: C10683),Hisar,Teacher Training,32,66,98,7,2,9,1,1,10.89,10.3
415,Haryana,Kurukshetra University Kurukshetra (Id: U0164),Aakash College of Education Jind (Id: C10650),Jind,Teacher Training,59,140,199,5,4,9,0,1,22.12,10.71
416,Haryana,Kurukshetra University Kurukshetra (Id: U0164),Haryana College of Education (Id: C10882),Jind,Teacher Training,0,0,0,0,0,0,1,1,0,6.67
417,Haryana,Kurukshetra University Kurukshetra (Id: U0164),Lala Ami Chand Monga Memorial College of Education (Id: C10592),Ambala,Teacher Training,113,119,232,13,9,22,0,0,10.55,3.52
418,Haryana,Kurukshetra University Kurukshetra (Id: U0164),Lord Krishna College of Education (Id: C10714),Ambala,Teacher Training,0,0,0,0,0,0,1,1,0,6.67
419,Haryana,Kurukshetra University Kurukshetra (Id: U0164),Panipat Institute of Engg. and Technology (Id: C10575),Panipat,Technical/Polytechnic,1700,751,2451,109,67,176,0,0,13.93,4.65
420,Haryana,Kurukshetra University Kurukshetra (Id: U0164),R.S. Memorial College of Education (Id: C10774),Panipat,Teacher Training,51,147,198,3,13,16,1,1,12.38,10.8
421,Haryana,Kurukshetra University Kurukshetra (Id: U0164),Shanti Niketan College of Education Agroha Mor (Id: C10547),Hisar,Teacher Training,0,0,0,0,0,0,0,0,0,0
422,Haryana,Maharshi Dayanand University Rohtak (Id: U0167),BASANT LAL MEMORIAL COLLEGE OF EDUCATION (Id: C28460),Gurgaon,Teacher Training,0,0,0,0,0,0,0,0,0,0
423,Haryana,Maharshi Dayanand University Rohtak (Id: U0167),B.S. A0GPURIA INSTITUTE OF EDUCATION (Id: C28064),Faridabad,Teacher Training,0,0,0,0,0,0,0,1,0,3.34
424,Haryana,Maharshi Dayanand University Rohtak (Id: U0167),CH. KATAR SINGH COLLEGE OF EDUCATION (Id: C28128),Sonipat,Teacher Training,0,0,0,0,0,0,0,0,0,0
425,Haryana,Maharshi Dayanand University Rohtak (Id: U0167),GOVERNMENT COLLEGE OF EDUCATION 0R0UL (Id: C28146),Mahendragarh,Teacher Training,10,88,98,2,0,2,1,0,49,19.67
426,Haryana,Maharshi Dayanand University Rohtak (Id: U0167),H.D. COLLEGE OF EDUCATION (Id: C28401),Jhajjar,Teacher Training,24,76,100,7,0,7,0,1,14.29,8.1
427,Haryana,Maharshi Dayanand University Rohtak (Id: U0167),H.J. INSTITUTE OF EDUCAITON and TECHNOLOGY (Id: C28150),Mahendragarh,Teacher Training,0,0,0,0,0,0,0,0,0,0
428,Haryana,Maharshi Dayanand University Rohtak (Id: U0167),J.R. KISSAN COLLEGE OF EDUCATION (Id: C28051),Rohtak,Teacher Training,0,0,0,0,0,0,0,0,0,0
429,Haryana,Maharshi Dayanand University Rohtak (Id: U0167),MODERN COLLEGE OF EDUCATION PALI (Id: C28333),Rewari,Teacher Training,23,72,95,5,4,9,1,0,10.56,6.86
430,Haryana,Maharshi Dayanand University Rohtak (Id: U0167),RAM JAS COLLEGE OF EDUCATION (Id: C28149),Sonipat,Teacher Training,14,36,50,4,4,8,1,1,6.25,8.75
431,Haryana,Maharshi Dayanand University Rohtak (Id: U0167),R.P.S. COLLEGE OF EDUCATION (Id: C28402),Mahendragarh,Teacher Training,39,61,100,6,2,8,1,0,12.5,7.5
432,Haryana,Maharshi Dayanand University Rohtak (Id: U0167),SARDAR PARTEL COLLEGE OF EDUCATION (Id: C28493),Gurgaon,Teacher Training,37,159,196,3,9,12,1,0,16.34,8.78
433,Haryana,Maharshi Dayanand University Rohtak (Id: U0167),SHIV KARAN COLLEGE OF EDUCATION (Id: C28217),Sonipat,Teacher Training,0,0,0,0,0,0,0,1,0,3.34
434,Haryana,Maharshi Dayanand University Rohtak (Id: U0167),SHRI SAI BABA COLLEGE OF EDUCATION (Id: C28118),Jhajjar,Teacher Training,20,78,98,3,4,7,1,1,14,11.34
435,Haryana,Maharshi Dayanand University Rohtak (Id: U0167),Vaish Arya Kanya Mahavidyalya Technology and Managemen (Id: C28482),Jhajjar,Technical/Polytechnic,0,55,55,1,12,13,0,1,4.24,4.75
436,Haryana,Maharshi Dayanand University Rohtak (Id: U0167),VAISH COLLEGE OF EDUCATION Rohtak (Id: C32597),Rohtak,Teacher Training,81,253,334,3,19,22,1,0,15.19,8.4
437,Haryana,Maharshi Dayanand University Rohtak (Id: U0167),V.B. COLLEGE OF EDUCATION (Id: C28381),Rohtak,Teacher Training,49,148,197,4,11,15,0,1,13.14,7.72
438,Haryana,Maharshi Dayanand University Rohtak (Id: U0167),VENKTESHWARA COLLEGE OF EDUCAITON (Id: C28354),Sonipat,Teacher Training,0,0,0,0,0,0,1,0,0,3.34
439,Haryana,Pt. Bhagat Dyal University of Health Science Rohtak (Id: U0174),Dr. Jai Parkash Sharma College of Nursing Yamunanagar (Id: C30772),Yamunanagar,Nursing,0,0,0,0,0,0,0,0,0,0
440,Haryana,Pt. Bhagat Dyal University of Health Science Rohtak (Id: U0174),Shrbati College of Nursing Gayushala Road Mahandergarh (Id: C30751),Mahendragarh,Nursing,0,0,0,0,0,0,1,0,0,3.34
441,Himachal Pradesh,Himachal Pradesh Technical University Hamirpur (Id: U0598),Himachal Institute of Engg. and Tech. Vidya Nagar Shahpur Kangra (Id: C11367),Kangra,Technical/Polytechnic,559,83,642,24,6,30,1,0,21.4,10.47
442,Himachal Pradesh,Himachal Pradesh Technical University Hamirpur (Id: U0598),SIRDA Institute of Engineering and Technology for Women Naulakda Troat Sunder Nagar Distt Mandi (Id: C11328),Mandi,Technical/Polytechnic,188,263,451,18,10,28,0,0,16.11,5.37
443,Himachal Pradesh,Himachal Pradesh University  Shimla (Id: U0183),Dr. Sharma Prasad Mukherjee College of Physical Education Nurpur Distt Kangra (Id: C11311),Kangra,Technical/Polytechnic,3,7,10,1,2,3,0,1,3.34,4.45
444,Himachal Pradesh,Himachal Pradesh University  Shimla (Id: U0183),Murari Lal Memorial College of Nursing Solan Distt. Solan (Id: C11310),Solan,Nursing,0,0,0,0,0,0,1,0,0,3.34
445,Himachal Pradesh,Himachal Pradesh University  Shimla (Id: U0183),Shiksha Bharti B.Ed College Kotla Khurd Distt Una (Id: C11260),Una,Teacher Training,0,0,0,0,0,0,1,0,0,3.34
446,Himachal Pradesh,Himachal Pradesh University  Shimla (Id: U0183),Shri Lal Devi Annapurna Sanskrit College Ramsheela Lakkar Bazar Kullu (Id: C11333),Kullu,Teacher Training,0,0,0,0,0,0,0,0,0,0
447,Jammu and Kashmir,University of Jammu Jammu Tawi (Id: U0195),Shivalik College of Education (Id: C22901),Udhampur,Teacher Training,78,123,201,2,8,10,1,0,20.1,10.04
448,Jammu and Kashmir,University of Kashmir Srinagar (Id: U0196),ALAMDAR COLLEGE OF EDUCATION BARAMULLAH (Id: C45959),Baramula,Teacher Training,0,0,0,0,0,0,0,0,0,0
449,Jammu and Kashmir,University of Kashmir Srinagar (Id: U0196),FRANKLIN COLLEGE OF EDUCATION BARAMULLAH (Id: C45963),Baramula,Teacher Training,75,56,131,9,4,13,1,1,10.08,10.03
450,Jammu and Kashmir,University of Kashmir Srinagar (Id: U0196),Govt. Dental College Srinagar (Id: C21425),Srinagar,Technical/Polytechnic,90,108,198,31,11,42,0,1,4.72,4.91
451,Jammu and Kashmir,University of Kashmir Srinagar (Id: U0196),SHADAB COLLEGE OF EDUCATION SRI0GAR (Id: C46011),Srinagar,Teacher Training,0,0,0,0,0,0,1,1,0,6.67
452,Jammu and Kashmir,University of Kashmir Srinagar (Id: U0196),SUBHAN INSTITUTE OF EDUCATIO0L TENCHNOLOGY BARAMULLAH (Id: C45973),Baramula,Teacher Training,0,0,0,0,0,0,1,1,0,6.67
453,Jammu and Kashmir,University of Kashmir Srinagar (Id: U0196),TAHIRA KHA0MS COLLEGE OF EDUCATION SRI0GAR (Id: C46013),Srinagar,Teacher Training,0,0,0,0,0,0,0,1,0,3.34
454,Jharkhand,NilamberPitamber University Palamu (Id: U0208),Anand Shanker Rotary B.Ed. CollegeChainpur (Id: C42764),Palamu,Teacher Training,50,50,100,6,2,8,0,1,12.5,7.5
455,Jharkhand,NilamberPitamber University Palamu (Id: U0208),Indra Singh B.Ed. CollegeGarhwa (Id: C42768),Garhwa,Teacher Training,40,60,100,8,2,10,0,1,10,6.67
456,Karnataka,Bangalore University Bangalore (Id: U0215),AE and CS Pavan College Physical Education Kolar563 101. (Id: C21083),Kolar,Teacher Training,18,16,34,6,0,6,0,1,5.67,5.23
457,Karnataka,Bangalore University Bangalore (Id: U0215),Chinmaya Institute of Management CO Chinmaya Mission Hospital CMH Road Indiranagar Bangalore 38. (Id: C20695),Bangalore,Technical/Polytechnic,0,0,0,0,0,0,0,1,0,3.34
458,Karnataka,Bangalore University Bangalore (Id: U0215),Indira B.Ed. College Boodkiote563 114 Bangarpet Taluk Kolar District. (Id: C20628),Kolar,Teacher Training,19,21,40,6,2,8,1,1,5,8.34
459,Karnataka,Bangalore University Bangalore (Id: U0215),S.J.E.S College of Hotel Mangament Medahalli Old Madras Road Bangalore49 (Id: C21136),Bangalore,Technical/Polytechnic,0,0,0,0,0,0,1,0,0,3.34
460,Karnataka,Bangalore University Bangalore (Id: U0215),Sri Gangarasa College of Fine Arts Kengal Channapatna571501. (Id: C20825),Ramanagara,Technical/Polytechnic,6,0,6,7,1,8,0,0,0.75,0.25
461,Karnataka,Bangalore University Bangalore (Id: U0215),University Vishweshwaraya College of Engineering (Id: C17613),Bangalore,Technical/Polytechnic,1899,822,2721,82,21,103,0,0,26.42,8.81
462,Karnataka,Davangere University Davangere (Id: U0218),Nutan College of EducationDavangere577004 (Id: C17729),Davanagere,Technical/Polytechnic,36,64,100,4,2,6,1,0,16.67,8.89
463,Karnataka,Gulbarga University Gulbarga (Id: U0219),B245 K R E Society College of Education Bidar (Id: C9261),Bidar,Teacher Training,16,33,49,4,4,8,0,0,6.13,2.05
464,Karnataka,Gulbarga University Gulbarga (Id: U0219),D494 Shivasharana Hemadri Mallama college Of Education Lingasugur (Id: C9234),Raichur,Teacher Training,0,0,0,0,0,0,0,0,0,0
465,Karnataka,Kannada University Hampi Kamalapura (Id: U0226),Aadarsha Chitrakala Mahavidyalaya Indi (Id: C26671),Bijapur,Technical/Polytechnic,0,0,0,0,0,0,0,0,0,0
466,Karnataka,Kannada University Hampi Kamalapura (Id: U0226),Basaveshwara Chitrakala Mahavidyalaya Basavakalyan (Id: C26720),Bidar,Technical/Polytechnic,46,26,72,13,1,14,0,0,5.15,1.72
467,Karnataka,Kannada University Hampi Kamalapura (Id: U0226),Bharatiya Kalakendra Dharwad (Id: C26672),Dharwad,Technical/Polytechnic,0,0,0,0,0,0,1,1,0,6.67
468,Karnataka,Kannada University Hampi Kamalapura (Id: U0226),Bhavani Lalitakala Mahavidyalaya Bellary (Id: C26688),Bellary,Teacher Training,0,0,0,0,0,0,1,1,0,6.67
469,Karnataka,Kannada University Hampi Kamalapura (Id: U0226),Bhuvaneshwari Lalitakala Mahavidyalaya Hoovinahadagali (Id: C26669),Bellary,Technical/Polytechnic,0,0,0,0,0,0,0,1,0,3.34
470,Karnataka,Kannada University Hampi Kamalapura (Id: U0226),Chalukya Chitrakala Mahavidyalaya Badami (Id: C26727),Bagalkot,Technical/Polytechnic,0,0,0,0,0,0,1,0,0,3.34
471,Karnataka,Kannada University Hampi Kamalapura (Id: U0226),Chikkodi Lalitakala Mahavidyalaya Chikkodi (Id: C26665),Belgaum,Technical/Polytechnic,0,0,0,0,0,0,0,1,0,3.34
472,Karnataka,Kannada University Hampi Kamalapura (Id: U0226),Chitrakala Mahavidyalaya Hoovinahipparagi (Id: C26738),Bijapur,Technical/Polytechnic,0,0,0,0,0,0,1,0,0,3.34
473,Karnataka,Kannada University Hampi Kamalapura (Id: U0226),Gurupadappa Chitrakala Mahavidyalaya Muddebihal (Id: C26701),Bijapur,Technical/Polytechnic,0,0,0,0,0,0,0,1,0,3.34
474,Karnataka,Kannada University Hampi Kamalapura (Id: U0226),Ilakal Vajrappa Chitrakala Mahavidyalaya Hosdurga (Id: C26739),Chitradurga,Technical/Polytechnic,18,17,35,5,0,5,0,1,7,5.67
475,Karnataka,Kannada University Hampi Kamalapura (Id: U0226),Karnataka Gadinadu Educational Trust Nippani (Id: C26736),Belgaum,Technical/Polytechnic,0,0,0,0,0,0,1,1,0,6.67
476,Karnataka,Kannada University Hampi Kamalapura (Id: U0226),Nootana Lalitakala Mahavidyalaya Lingasugur (Id: C26767),Raichur,Teacher Training,0,0,0,0,0,0,0,0,0,0
477,Karnataka,Kannada University Hampi Kamalapura (Id: U0226),Nootana Lalitakala Mahavidyalaya Sindhanoor (Id: C26730),Raichur,Technical/Polytechnic,0,0,0,0,0,0,0,1,0,3.34
478,Karnataka,Kannada University Hampi Kamalapura (Id: U0226),Priyankagandhi Fine Arts College Gulbarga (Id: C26676),Gulbarga,Teacher Training,0,0,0,0,0,0,1,1,0,6.67
479,Karnataka,Kannada University Hampi Kamalapura (Id: U0226),Ranga Study Centre Kundapur (Id: C26680),Udupi,Technical/Polytechnic,5,2,7,14,0,14,1,0,0.5,3.5
480,Karnataka,Kannada University Hampi Kamalapura (Id: U0226),Ravindra Chitrakalaniketan Rona (Id: C26693),Gadag,Technical/Polytechnic,0,0,0,0,0,0,1,1,0,6.67
481,Karnataka,Kannada University Hampi Kamalapura (Id: U0226),Shivayogishwara Lalitakala Mahavidyalaya Bailhongal (Id: C26663),Belgaum,Technical/Polytechnic,13,1,14,3,1,4,1,0,3.5,4.5
482,Karnataka,Kannada University Hampi Kamalapura (Id: U0226),Siddarth Lalitakala Vidyalaya Gokak (Id: C26752),Belgaum,Technical/Polytechnic,76,16,92,4,2,6,1,0,15.34,8.45
483,Karnataka,Kannada University Hampi Kamalapura (Id: U0226),SJPD Chitrakala Mahavidyalaya Balki (Id: C26733),Bidar,Technical/Polytechnic,9,4,13,10,0,10,1,1,1.3,7.1
484,Karnataka,Kannada University Hampi Kamalapura (Id: U0226),S.M. Pandit Fine Arts Bidar (Id: C26757),Bidar,Technical/Polytechnic,18,17,35,6,0,6,0,1,5.84,5.28
485,Karnataka,Kannada University Hampi Kamalapura (Id: U0226),Sri Jagduguru Panchachairya Chitrakala Mahavidyalaya Shimoga (Id: C26726),Shimoga,Technical/Polytechnic,0,0,0,0,0,0,0,1,0,3.34
486,Karnataka,Kannada University Hampi Kamalapura (Id: U0226),Sri SBSS Fine Arts College Rattihalli (Id: C26654),Haveri,Teacher Training,0,0,0,0,0,0,0,1,0,3.34
487,Karnataka,Kannada University Hampi Kamalapura (Id: U0226),The Ideal Fine Arts Institute Gulbarga (Id: C26656),Gulbarga,Teacher Training,0,0,0,0,0,0,1,0,0,3.34
488,Karnataka,Kannada University Hampi Kamalapura (Id: U0226),Vani Chitrakala Shale Chikkanayakanahalli (Id: C26745),Tumkur,Teacher Training,33,11,44,4,1,5,0,0,8.8,2.94
489,Karnataka,Kannada University Hampi Kamalapura (Id: U0226),Vani Chitrakala Shale Chikkanayakanahalli (Id: C26745),Tumkur,Technical/Polytechnic,33,11,44,4,1,5,1,0,8.8,6.27
490,Karnataka,Kannada University Hampi Kamalapura (Id: U0226),Vishwavinutana Chitrakala Mahavidyalaya Bagalkot (Id: C26722),Bagalkot,Technical/Polytechnic,14,3,17,1,2,3,1,0,5.67,5.23
491,Karnataka,Karnataka State Women University Bijapur (Id: U0229),JMM's Sundrabai A. Patil Education College for Women Tilakwadi Belguam590 006 (Id: C8651),Belgaum,Teacher Training,0,0,0,0,0,0,0,1,0,3.34
492,Karnataka,Karnataka University Dharwad (Id: U0230),RTE Societys College of Education Ranebennur (Id: C35592),Haveri,Teacher Training,41,59,100,4,4,8,0,1,12.5,7.5
493,Karnataka,Karnataka University Dharwad (Id: U0230),Rural B.Ed College Sattur P.B.Road Dharwad. (Id: C35565),Dharwad,Teacher Training,66,43,109,7,1,8,0,1,13.63,7.88
494,Karnataka,Karnataka University Dharwad (Id: U0230),Shri Channabasaveshwar Education Societies Shri. Sai B.Ed College Navanagar Hubli. (Id: C35516),Dharwad,Teacher Training,48,52,100,4,3,7,0,0,14.29,4.77
495,Karnataka,Karnataka University Dharwad (Id: U0230),Shri. Channabasaveshwar Shikshna Samste Shri. Sai Phy. College Navanagar Hubli. (Id: C35658),Dharwad,Teacher Training,34,16,50,6,1,7,0,0,7.15,2.39
496,Karnataka,Karnataka University Dharwad (Id: U0230),V.H Marad M.Ed College Sattur Dharwad (Id: C35506),Dharwad,Teacher Training,12,17,29,4,1,5,1,1,5.8,8.6
497,Karnataka,Kuvempu University Shankaraghatta Shimoga (Id: U0232),S.J.G. College of Education Anandapura Sagara Taluka. (Id: C17840),Shimoga,Teacher Training,40,60,100,7,1,8,1,0,12.5,7.5
498,Karnataka,Mangalore University Mangalore (Id: U0233),Mangalore Institute of Fire and Safety Engineering C.P. Complex Pumpwell Mangalore (Id: C16803),Dakshina Kannada,Technical/Polytechnic,0,0,0,0,0,0,0,1,0,3.34
499,Karnataka,Maulana Azad National Urdu University Hyderabad (Id: U0023),MANUU POLYTECHNIC BANGALORE (Id: C46611),Bangalore,Technical/Polytechnic,295,0,295,19,0,19,1,1,15.53,11.85
500,Karnataka,Mysore University Mysore (Id: U0235),NDRK College for Education B M Road Hassan (Id: C17519),Hassan,Teacher Training,19,81,100,6,3,9,1,1,11.12,10.38
501,Karnataka,Mysore University Mysore (Id: U0235),RAMAKRISH0 INSTTITUTE OF MORAL AND SPIRITUAL EDUCATION MYSORE (Id: C46338),Mysore,Teacher Training,100,0,100,9,0,9,1,0,11.12,7.04
502,Karnataka,Rajiv Gandhi University of Health Sciences Bangalore (Id: U0240),A E C S Maruthi College of Nursing (Id: C40319),Bangalore,Nursing,43,59,102,3,23,26,1,1,3.93,7.98
503,Karnataka,Rajiv Gandhi University of Health Sciences Bangalore (Id: U0240),AECS Pavan College of Nursing (Id: C40398),Kolar,Nursing,58,179,237,7,27,34,0,1,6.98,5.66
504,Karnataka,Rajiv Gandhi University of Health Sciences Bangalore (Id: U0240),Aruna College of Nursing (Id: C40371),Tumkur,Nursing,8,43,51,0,47,47,0,1,1.09,3.7
505,Karnataka,Rajiv Gandhi University of Health Sciences Bangalore (Id: U0240),ASHRITH COLLEGE OF NURSING KOTAUDUPI (Id: C46585),Udupi,Nursing,0,54,54,2,8,10,0,1,5.4,5.14
506,Karnataka,Rajiv Gandhi University of Health Sciences Bangalore (Id: U0240),Bellary Institute of Nursing (Id: C40515),Bellary,Nursing,7,27,34,2,12,14,0,0,2.43,0.81
507,Karnataka,Rajiv Gandhi University of Health Sciences Bangalore (Id: U0240),Government Dental College Bellary (Id: C40520),Bellary,Technical/Polytechnic,50,109,159,18,17,35,1,0,4.55,4.85
508,Karnataka,Rajiv Gandhi University of Health Sciences Bangalore (Id: U0240),Hassan Institute of Medical Sciences (Id: C40164),Hassan,Nursing,313,286,599,108,47,155,1,1,3.87,7.96
509,Karnataka,Rajiv Gandhi University of Health Sciences Bangalore (Id: U0240),Indian College of Nursing (Id: C40187),Bangalore,Nursing,0,32,32,0,9,9,0,0,3.56,1.19
510,Karnataka,Rajiv Gandhi University of Health Sciences Bangalore (Id: U0240),Koshys College of Nursing (Id: C40591),Bangalore,Nursing,54,242,296,0,28,28,1,1,10.58,10.2
511,Karnataka,Rajiv Gandhi University of Health Sciences Bangalore (Id: U0240),Mathrusri Ramabai Ambedkar College of Nursing Bangalore (Id: C44852),Bangalore,Nursing,38,96,134,1,5,6,1,1,22.34,14.12
512,Karnataka,Rajiv Gandhi University of Health Sciences Bangalore (Id: U0240),Mother Teresa College of Nursing (Id: C40201),Mysore,Nursing,8,128,136,0,5,5,1,0,27.2,12.4
513,Karnataka,Rajiv Gandhi University of Health Sciences Bangalore (Id: U0240),Mythri College of Nursing (Id: C40552),Shimoga,Nursing,22,206,228,9,30,39,0,1,5.85,5.29
514,Karnataka,Rajiv Gandhi University of Health Sciences Bangalore (Id: U0240),Nanjappa Institute of Nursing Sciences (Id: C40545),Shimoga,Nursing,5,194,199,8,76,84,0,0,2.37,0.79
515,Karnataka,Rajiv Gandhi University of Health Sciences Bangalore (Id: U0240),Narayana Hrudayalaya College of Nursing (Id: C40355),Bangalore,Nursing,9,272,281,1,41,42,1,0,6.7,5.57
516,Karnataka,Rajiv Gandhi University of Health Sciences Bangalore (Id: U0240),New Sri Shanthini College of Nursing (Id: C40074),Bangalore,Nursing,72,95,167,6,14,20,1,0,8.35,6.12
517,Karnataka,Rajiv Gandhi University of Health Sciences Bangalore (Id: U0240),Nightingale College Of Nursing (Id: C40455),Bangalore,Nursing,105,230,335,5,50,55,0,1,6.1,5.37
518,Karnataka,Rajiv Gandhi University of Health Sciences Bangalore (Id: U0240),Rajiv Gandhi College of Nursing (Id: C40422),Bangalore,Nursing,28,64,92,20,25,45,1,0,2.05,4.02
519,Karnataka,Rajiv Gandhi University of Health Sciences Bangalore (Id: U0240),SCT College of Nursing (Id: C40403),Bangalore,Nursing,0,0,0,0,0,0,1,1,0,6.67
520,Karnataka,Rajiv Gandhi University of Health Sciences Bangalore (Id: U0240),Shri maruthi College of Nursing (Id: C44903),Bangalore Rural,Nursing,0,0,0,0,1,1,0,0,0,0
521,Karnataka,Rajiv Gandhi University of Health Sciences Bangalore (Id: U0240),Smt. Lakshmi Devi College of Nursing (Id: C44904),Bangalore Rural,Nursing,2,75,77,7,19,26,1,0,2.97,4.33
522,Karnataka,Rajiv Gandhi University of Health Sciences Bangalore (Id: U0240),Sri Devaraj Urs College of Nursing (Id: C40165),Kolar,Nursing,7,168,175,2,22,24,0,0,7.3,2.44
523,Karnataka,Rajiv Gandhi University of Health Sciences Bangalore (Id: U0240),Sri Dharmasthala Manjunatheshwara College of Nursing (Id: C40557),Dharwad,Nursing,21,254,275,9,9,18,1,1,15.28,11.76
524,Karnataka,Rajiv Gandhi University of Health Sciences Bangalore (Id: U0240),Sri Venkateshwara Institute of Nursing Sciences Hongasandra (Id: C44870),Bangalore,Nursing,0,26,26,0,16,16,1,0,1.63,3.88
525,Karnataka,Rajiv Gandhi University of Health Sciences Bangalore (Id: U0240),UDUPI DHANVANTARI COLLEGE OF NURSING UDUPI (Id: C47416),Udupi,Nursing,0,73,73,3,7,10,0,0,7.3,2.44
526,Karnataka,Rajiv Gandhi University of Health Sciences Bangalore (Id: U0240),Unity College of Nursing (Id: C40240),Dakshina Kannada,Nursing,0,186,186,1,27,28,0,1,6.65,5.55
527,Karnataka,Rajiv Gandhi University of Health Sciences Bangalore (Id: U0240),Wockhardt Institute of Nursing (Id: C40217),Bangalore,Nursing,16,136,152,3,8,11,1,1,13.82,11.28
528,Karnataka,Rani Channamma University Belagavi (Id: U0602),BASAVESHWAR COLLEGE OF PHYSICAL EDUCATION BAGALKOTE (PG) (Id: C9979),Bagalkot,Teacher Training,126,12,138,8,0,8,1,1,17.25,12.42
529,Karnataka,Rani Channamma University Belagavi (Id: U0602),BHRATESH COLLEGE OF EDUCATION BELLAD BAGEWADI (Id: C10188),Belgaum,Teacher Training,56,41,97,5,4,9,0,0,10.78,3.6
530,Karnataka,Rani Channamma University Belagavi (Id: U0602),CHAUSON COLLEGE OF EDUCATION CHIKKODI (Id: C9893),Belgaum,Teacher Training,62,38,100,7,3,10,1,1,10,10
531,Karnataka,Rani Channamma University Belagavi (Id: U0602),CHAUSON EDUCATION COLLEGE CHIKKODI (PG) (Id: C10063),Belgaum,Teacher Training,8,14,22,3,3,6,0,0,3.67,1.23
532,Karnataka,Rani Channamma University Belagavi (Id: U0602),CHOUSAN COLLEGE OF EDUCATION CHIKKODI (Id: C9893),Belgaum,Teacher Training,62,38,100,7,3,10,1,1,10,10
533,Karnataka,Rani Channamma University Belagavi (Id: U0602),CHOUSON EDUCATION COLLEGE CHIKKODI (PG) (Id: C10063),Belgaum,Teacher Training,8,14,22,3,3,6,1,0,3.67,4.56
534,Karnataka,Rani Channamma University Belagavi (Id: U0602),KLE SOCIETYS COLLEGE OF EDUCATION ATHANI (Id: C9947),Belgaum,Teacher Training,47,46,93,3,3,6,1,1,15.5,11.84
535,Karnataka,Rani Channamma University Belagavi (Id: U0602),M N R A EDUCATION COLLEGE BELGAUM (Id: C10211),Belgaum,Teacher Training,55,45,100,8,6,14,0,1,7.15,5.72
536,Karnataka,Rani Channamma University Belagavi (Id: U0602),SHRI SIDDHIVI0YAKA RURAL COLLEGE OF EDUCATION HARUGERI (Id: C10144),Belgaum,Teacher Training,62,19,81,7,1,8,0,0,10.13,3.38
537,Karnataka,Rashtriya Sanskrit Sansthan New Delhi (Id: U0115),RAJIV GANDHI CAMPUS (Id: C27024),Chikmagalur,Teacher Training,0,0,0,0,0,0,0,0,0,0
538,Karnataka,University of Agricultural Sciences Dharwad (Id: U0246),COLLEGE OF FORESTRYSIRSI (Id: C44536),Uttara Kannada,Technical/Polytechnic,0,0,0,0,0,0,0,0,0,0
539,Karnataka,Vesveswaraiah Technological University Belgaum (Id: U0249),AIR FORCE TECHNICAL COLLEGE BANGALORE (Id: C47267),Bangalore,Technical/Polytechnic,0,0,0,0,0,0,0,1,0,3.34
540,Karnataka,Vesveswaraiah Technological University Belgaum (Id: U0249),Vijaya Vittal Institute of Technology BANGALORE (Id: C1257),Bangalore,Technical/Polytechnic,0,0,0,0,0,0,1,0,0,3.34
541,Kerala,Calicut University Thenhipalem Malapuram (Id: U0251),KPPM COLLEGE OF TEACHER EDUCATION A0KKAYAM (Id: C7998),Malappuram,Teacher Training,18,83,101,6,6,12,0,0,8.42,2.81
542,Kerala,Calicut University Thenhipalem Malapuram (Id: U0251),SAHRUDAYA COLLEGE OF ENGG and TECH. KODAKARA (Id: C8157),Thrissur,Technical/Polytechnic,375,645,1020,26,55,81,0,0,12.6,4.2
543,Kerala,Kannur University Kannur (Id: U0256),Sadguru Swamy Nithyananda Institute of Technology Kanhangad (Id: C43844),Kasaragod,Technical/Polytechnic,0,0,0,0,0,0,0,1,0,3.34
544,Kerala,KERALA UNIVERSITY OF HEALTH AND ALLIED SCIENCES (Id: U0630),JAMIA SALAFFIYYA COLLEGE OF PHARMACY PULIKKAL (Id: C8013),Malappuram,Technical/Polytechnic,0,0,0,0,0,0,1,1,0,6.67
545,Kerala,KERALA UNIVERSITY OF HEALTH AND ALLIED SCIENCES (Id: U0630),KMCT COLLEGE OF NURSING MAMPATTA KOZHIKKODE (Id: C8194),Kozhikode,Nursing,15,169,184,2,15,17,1,0,10.83,6.95
546,Kerala,KERALA UNIVERSITY OF HEALTH AND ALLIED SCIENCES (Id: U0630),Lissie College of Nursing Lissie Hospital P B No. 3053 Ernakulam 682 018 (Id: C11703),Ernakulam,Nursing,4,282,286,0,33,33,1,0,8.67,6.23
547,Kerala,Kerala University Thiruvananthapuram (Id: U0260),College of Teacher Education Arkannor Ayur Kollam (Id: C43641),Kollam,Teacher Training,2,11,13,4,4,8,1,1,1.63,7.21
548,Kerala,Mahatma Gandhi University Kottayam (Id: U0262),Sneha Sadan College of Special education Angamaly Ernakulam  683 572 (Id: C11586),Ernakulam,Teacher Training,1,23,24,0,9,9,1,1,2.67,7.56
549,Kerala,Mahatma Gandhi University Kottayam (Id: U0262),S N M Training College Moothakunnam Ernakulam 683 516 (Id: C11632),Ernakulam,Teacher Training,6,171,177,5,12,17,1,1,10.42,10.14
550,Kerala,Mahatma Gandhi University Kottayam (Id: U0262),University College of Teacher Education Vocational Higher Secondary School Campus Elanthoor Pathanamthitta (Id: C11791),Pathanamthitta,Teacher Training,18,128,146,3,7,10,0,0,14.6,4.87
551,Madhya Pradesh,Awadesh Pratap Singh University Rewa (Id: U0268),CHAURASHIYA PAIRAMEDICAL INSTITUT REWA (Id: C31835),Rewa,Technical/Polytechnic,240,60,300,29,14,43,0,1,6.98,5.66
552,Madhya Pradesh,Awadesh Pratap Singh University Rewa (Id: U0268),MASS PARAMEDICAL INSTITUTE SAT0 (Id: C31802),Satna,Technical/Polytechnic,0,0,0,0,0,0,0,1,0,3.34
553,Madhya Pradesh,Awadesh Pratap Singh University Rewa (Id: U0268),M.J M C NURSING and REASEARCHSHERGANJSAT0 (Id: C31794),Satna,Nursing,0,0,0,0,0,0,0,0,0,0
554,Madhya Pradesh,Awadesh Pratap Singh University Rewa (Id: U0268),SAI0TH INSTITUTE OF PARAMEDICAL TECHNOLOGY  VAIDHAN (Id: C47489),Singrauli,Technical/Polytechnic,0,0,0,0,0,0,0,1,0,3.34
555,Madhya Pradesh,Awadesh Pratap Singh University Rewa (Id: U0268),SAKSHI B.ED. COLLEGE BARAURA SIDHI (Id: C50398),Sidhi,Teacher Training,0,0,0,0,0,0,0,1,0,3.34
556,Madhya Pradesh,Awadesh Pratap Singh University Rewa (Id: U0268),SHIVANI PARAMADICAL INSTITUTESHAHDOL (Id: C31889),Shahdol,Nursing,0,0,0,0,0,0,1,1,0,6.67
557,Madhya Pradesh,Awadesh Pratap Singh University Rewa (Id: U0268),S. I. N. P. S. JANKI KUND CHITRAKUT SAT0 (Id: C31830),Satna,Technical/Polytechnic,52,6,58,8,0,8,0,1,7.25,5.75
558,Madhya Pradesh,Barkatullah University Bhopal (Id: U0269),CHIRAYU PARAMEDICAL COLLEGE (Id: C50446),Bhopal,Technical/Polytechnic,0,0,0,0,0,0,0,1,0,3.34
559,Madhya Pradesh,Barkatullah University Bhopal (Id: U0269),RAJA BHOJ COLLEGE OF EDUCATION (Id: C47994),Betul,Teacher Training,31,69,100,7,1,8,1,0,12.5,7.5
560,Madhya Pradesh,Devi Ahilya Vishwavidyalaya Indore (Id: U0270),Shri Guru Gobind Singh College of Prof. Studies Khandwa Road Indore (Id: C29778),Indore,Technical/Polytechnic,66,54,120,8,4,12,1,1,10,10
561,Madhya Pradesh,Devi Ahilya Vishwavidyalaya Indore (Id: U0270),Shubhdeep College of Nursing Indore (Id: C47331),Indore,Nursing,30,47,77,4,15,19,1,1,4.06,8.02
562,Madhya Pradesh,Devi Ahilya Vishwavidyalaya Indore (Id: U0270),Shubhdeep College of Nursing Indore (Id: C47331),Indore,Nursing,30,47,77,4,15,19,1,0,4.06,4.69
563,Madhya Pradesh,Devi Ahilya Vishwavidyalaya Indore (Id: U0270),SMT RUKHMINIBEN DEEPCHAND BHAI GARDI NTC INDORE (Id: C47955),Indore,Nursing,1,131,132,0,14,14,1,1,9.43,9.81
564,Madhya Pradesh,Dr. Harisingh Gaur Vishwavidyalaya Sagar (Id: U0271),Bhagyodaya Teerth Inst. and Paramedical Sc. College Sagar. (Id: C19133),Sagar,Technical/Polytechnic,13,9,22,6,0,6,0,0,3.67,1.23
565,Madhya Pradesh,Dr. Harisingh Gaur Vishwavidyalaya Sagar (Id: U0271),Chhatrasal Edu. College Devendranagar Panna (Id: C19257),Panna,Teacher Training,49,51,100,12,2,14,0,1,7.15,5.72
566,Madhya Pradesh,Dr. Harisingh Gaur Vishwavidyalaya Sagar (Id: U0271),Hope Inst. of Tech. Teachers Tranning Tikamgarh (Id: C19189),Tikamgarh,Teacher Training,52,48,100,6,2,8,1,0,12.5,7.5
567,Madhya Pradesh,Dr. Harisingh Gaur Vishwavidyalaya Sagar (Id: U0271),R.A.B.L. College Chhindwara (Id: C19125),Chhindwara,Technical/Polytechnic,0,0,0,0,0,0,1,0,0,3.34
568,Madhya Pradesh,Dr. Harisingh Gaur Vishwavidyalaya Sagar (Id: U0271),Rajashwari Mahavidyalaya Madhoganj Ajaygarh.Panna (Id: C19203),Panna,Teacher Training,0,0,0,0,0,0,1,0,0,3.34
569,Madhya Pradesh,Dr. Harisingh Gaur Vishwavidyalaya Sagar (Id: U0271),Srijan Edu. College Chhatarpur (Id: C19178),Chhatarpur,Teacher Training,38,62,100,6,2,8,1,0,12.5,7.5
570,Madhya Pradesh,Dr. Harisingh Gaur Vishwavidyalaya Sagar (Id: U0271),Vidyasagar College Devendranagar Panna (Id: C19237),Panna,Teacher Training,53,46,99,7,1,8,1,0,12.38,7.46
571,Madhya Pradesh,Indira Kala Sangit Vishwavidyalaya Khairagarh (Id: U0088),IPS Academy Indore  452 012 (Id: C33077),Indore,Teacher Training,0,0,0,0,0,0,0,1,0,3.34
572,Madhya Pradesh,Indira Kala Sangit Vishwavidyalaya Khairagarh (Id: U0088),Nutan Kala Sangeet MahavidyalayaBalaghat (Id: C33062),Balaghat,Teacher Training,0,0,0,0,0,0,1,1,0,6.67
573,Madhya Pradesh,Indira Kala Sangit Vishwavidyalaya Khairagarh (Id: U0088),Sangeet MahavidyalayaGujrati Samaj Ratlam457001 (Id: C33030),Ratlam,Technical/Polytechnic,0,0,0,0,0,0,0,0,0,0
574,Madhya Pradesh,Jiwaji University Gwalior (Id: U0276),COLLEGE OF LIFE SCIENCE CENTER HOSPITAL AND RESEARCH INSTITUTE (Id: C34787),Gwalior,Technical/Polytechnic,31,88,119,4,9,13,0,0,9.16,3.06
575,Madhya Pradesh,Jiwaji University Gwalior (Id: U0276),OMKAR COLLEGE OF PROF. STUDIES (Id: C34934),Guna,Technical/Polytechnic,0,0,0,0,0,0,1,1,0,6.67
576,Madhya Pradesh,Jiwaji University Gwalior (Id: U0276),RAJIV GANDHI PROF. STUDIES COLLEGE URWAI GATE (Id: C34801),Gwalior,Teacher Training,126,109,235,10,10,20,0,0,11.75,3.92
577,Madhya Pradesh,Jiwaji University Gwalior (Id: U0276),RISHI GALAV COLLEGE  BANMORE (Id: C34931),Morena,Teacher Training,298,155,453,13,0,13,0,1,34.85,14.95
578,Madhya Pradesh,Jiwaji University Gwalior (Id: U0276),SO0LI EDUCATION COLLEGE (Id: C34945),Guna,Teacher Training,39,61,100,7,1,8,1,1,12.5,10.84
579,Madhya Pradesh,Jiwaji University Gwalior (Id: U0276),VIVEKA0ND PARAMEDICAL COLLEGE (Id: C34913),Bhind,Technical/Polytechnic,82,18,100,3,1,4,1,0,25,11.67
580,Madhya Pradesh,Rajiv Gandhi Prodoyogiki Vishwavidyalaya Bhopal (Id: U0287),Bhabha College Of Pharmacy Village JatkhediN.H.12Hoshangabad Road BHOPA (Id: C36109),Bhopal,Technical/Polytechnic,0,0,0,0,0,0,0,1,0,3.34
581,Madhya Pradesh,Rajiv Gandhi Prodoyogiki Vishwavidyalaya Bhopal (Id: U0287),"""Central India Institute of PharmacyDewasIndore Highway Arandia Indore452001 "" (Id: C36120)",Indore,Technical/Polytechnic,95,25,120,3,5,8,0,0,15,5
582,Madhya Pradesh,Rajiv Gandhi Prodoyogiki Vishwavidyalaya Bhopal (Id: U0287),Dr. Shri R.M.S. Institute of Science and Technology College of Pharmacy Bhanpura Dist  Mandsaur458775 (Id: C36261),Mandsaur,Technical/Polytechnic,300,45,345,29,1,30,0,0,11.5,3.84
583,Madhya Pradesh,Rajiv Gandhi Prodoyogiki Vishwavidyalaya Bhopal (Id: U0287),Gulab Kali Memorial College Of PharmacyGora Road Chakghat PostChakghat Teh.Teonthar Distt.Rewa486226 (Id: C36113),Rewa,Technical/Polytechnic,0,0,0,0,0,0,1,1,0,6.67
584,Madhya Pradesh,Rajiv Gandhi Prodoyogiki Vishwavidyalaya Bhopal (Id: U0287),R.K.D.F.Institute Of Pharmacy Science Bhopal N.H. 12 Hoshangabad Road Near Mark Hotel Bhopal (Id: C35918),Bhopal,Technical/Polytechnic,71,19,90,5,3,8,1,0,11.25,7.09
585,Madhya Pradesh,Rajiv Gandhi Prodoyogiki Vishwavidyalaya Bhopal (Id: U0287),R.K.D.F. Instt. of Pharmacy Science Indore (Id: C36104),Indore,Technical/Polytechnic,68,12,80,7,1,8,0,0,10,3.34
586,Madhya Pradesh,Rajiv Gandhi Prodoyogiki Vishwavidyalaya Bhopal (Id: U0287),R.K.D.F. Poly. (Pharmacy) N.H. 12 Hoshangabad Road Near Mark Hotel Bhopal (Id: C36254),Bhopal,Technical/Polytechnic,98,12,110,5,2,7,1,1,15.72,11.91
587,Madhya Pradesh,Rajiv Gandhi Prodoyogiki Vishwavidyalaya Bhopal (Id: U0287),Shri Ram Institute of Tech. Diploma Pharmacy Near I.T.I. Madatal Jabalpur482002 (Id: C36183),Jabalpur,Technical/Polytechnic,0,0,0,0,0,0,0,0,0,0
588,Madhya Pradesh,Rajiv Gandhi Prodoyogiki Vishwavidyalaya Bhopal (Id: U0287),Shri Satya Sai Poly. Pharmacy N.H.18 Oposit Oil Faid Plant Pachama Sehore (Id: C35977),Sehore,Technical/Polytechnic,60,17,77,6,2,8,1,1,9.63,9.88
589,Madhya Pradesh,Rajiv Gandhi Prodoyogiki Vishwavidyalaya Bhopal (Id: U0287),S.V. Polytechnic Mahavidyalaya Bhopal (Id: C36037),Bhopal,Technical/Polytechnic,0,0,0,0,0,0,0,0,0,0
590,Madhya Pradesh,Rajiv Gandhi Prodoyogiki Vishwavidyalaya Bhopal (Id: U0287),Swami Vivekanad Institute of Technology Behind Dr. H.S. Gaur University NH 26 Sironja Sagar (Id: C36124),Sagar,Technical/Polytechnic,1124,393,1517,76,26,102,1,0,14.88,8.3
591,Madhya Pradesh,Rajiv Gandhi Prodoyogiki Vishwavidyalaya Bhopal (Id: U0287),Swami Vivekanand College Of Pharmacy Barkhedi Kala Neelbad RoadP.O.Suraj Nagar Bhopal462044 (Id: C36062),Bhopal,Technical/Polytechnic,52,8,60,5,3,8,1,1,7.5,9.17
592,Madhya Pradesh,Rajiv Gandhi Prodoyogiki Vishwavidyalaya Bhopal (Id: U0287),University Polytechnic RGPV (Id: C36082),Bhopal,Technical/Polytechnic,432,49,481,8,1,9,1,1,53.45,24.49
593,Madhya Pradesh,Rani Durgavati Vishwavidyalaya Jabalpur (Id: U0289),BALAGHAT PERAMEDICAL COLLEGE (Id: C47343),Balaghat,Technical/Polytechnic,69,130,199,11,4,15,0,0,13.27,4.43
594,Madhya Pradesh,Rani Durgavati Vishwavidyalaya Jabalpur (Id: U0289),BANSAL INSTITUTE OF PARAMEDICAL SCIENCE Jabalpur (Id: C47386),Jabalpur,Technical/Polytechnic,15,4,19,0,3,3,1,0,6.34,5.45
595,Madhya Pradesh,Rani Durgavati Vishwavidyalaya Jabalpur (Id: U0289),JAGAN0TH PREMVATI COLLEGE OF EDUCATION Jabalpur (Id: C47391),Jabalpur,Teacher Training,0,0,0,1,8,9,1,1,0,6.67
596,Madhya Pradesh,Rani Durgavati Vishwavidyalaya Jabalpur (Id: U0289),MAHAKOSHAL INSTITUTE OF PARAMEDICAL TECHOLOGY Jabalpur (Id: C47394),Jabalpur,Technical/Polytechnic,67,24,91,4,3,7,1,1,13,11
597,Madhya Pradesh,Rani Durgavati Vishwavidyalaya Jabalpur (Id: U0289),MANDLA INSTITUDE OF PARAMEDICAL TECHNOLOGY (Id: C47362),Mandla,Technical/Polytechnic,50,39,89,3,4,7,1,1,12.72,10.91
598,Madhya Pradesh,Rani Durgavati Vishwavidyalaya Jabalpur (Id: U0289),SAI 0TH COLLEGE OF NURSING KATNI (Id: C47359),Katni,Nursing,0,0,0,0,0,0,0,1,0,3.34
599,Madhya Pradesh,Rani Durgavati Vishwavidyalaya Jabalpur (Id: U0289),SUBHASH CHANDRA PARAMEDICAL COLLEGE Jabalpur (Id: C47398),Jabalpur,Technical/Polytechnic,60,21,81,14,5,19,1,0,4.27,4.76
600,Madhya Pradesh,Rani Durgavati Vishwavidyalaya Jabalpur (Id: U0289),Swayam Shri Institute of Paramedical Technology Balaghat (Id: C33433),Balaghat,Technical/Polytechnic,96,76,172,5,6,11,0,0,15.64,5.22
601,Madhya Pradesh,Vikram University Ujjain (Id: U0291),Balkavi Bairagee Education College Neemuch (Id: C31629),Neemuch,Teacher Training,15,85,100,2,7,9,1,1,11.12,10.38
602,Madhya Pradesh,Vikram University Ujjain (Id: U0291),Govt. Mahatma Gandhi College Jawad (Id: C31646),Neemuch,Teacher Training,182,298,480,8,1,9,1,0,53.34,21.12
603,Madhya Pradesh,Vikram University Ujjain (Id: U0291),Maharaja College of Ujjain Ujjain (Id: C31628),Ujjain,Teacher Training,0,0,0,0,0,0,0,0,0,0
604,Madhya Pradesh,Vikram University Ujjain (Id: U0291),Mandsaur Institute of Physical Education Mandsaur (Id: C31695),Mandsaur,Teacher Training,0,0,0,0,0,0,1,0,0,3.34
605,Madhya Pradesh,Vikram University Ujjain (Id: U0291),MIRACLES MANDSAUR (Id: C47240),Mandsaur,Technical/Polytechnic,44,6,50,6,1,7,1,1,7.15,9.05
606,Maharashtra,Dr. Babasaheb Ambedkar Marathwada University Aurangabad (Id: U0298),Ashti Taluka Shikshan Prasarak Mandal's Arts and Commerce College Ashti. (Id: C34527),Bid,Teacher Training,508,190,698,27,4,31,1,1,22.52,14.18
607,Maharashtra,Dr. Babasaheb Ambedkar Marathwada University Aurangabad (Id: U0298),Terna Public Charitable Trust's College of Education Terna Nagar. (Id: C34575),Osmanabad,Teacher Training,42,41,83,4,1,5,1,1,16.6,12.2
608,Maharashtra,Dr. Babasaheb Ambedkar Marathwada University Aurangabad (Id: U0298),Terna Public Charitable Trust's College of Education Terna Nagar. (Id: C34575),Osmanabad,Technical/Polytechnic,42,41,83,4,1,5,0,1,16.6,8.87
609,Maharashtra,GONDWA0 UNIVERSITY GADCHIROLI (Id: U0658),Chintamani B Ed College Ballarpur (Id: C18334),Chandrapur,Teacher Training,48,26,74,8,0,8,1,1,9.25,9.75
610,Maharashtra,GONDWA0 UNIVERSITY GADCHIROLI (Id: U0658),Late Gyaneshwarji Menghre Education College Wadsa (Id: C18687),Gadchiroli,Teacher Training,0,0,0,0,0,0,0,0,0,0
611,Maharashtra,GONDWA0 UNIVERSITY GADCHIROLI (Id: U0658),SATI ANUSAYA MAA ARTS SCIENCE COLLEGE YENGALKHEDA (Id: C46513),Gadchiroli,Teacher Training,35,19,54,3,2,5,1,0,10.8,6.94
612,Maharashtra,GONDWA0 UNIVERSITY GADCHIROLI (Id: U0658),Sharadchandra Pawar Arts College Charmoshi (Id: C18606),Gadchiroli,Teacher Training,0,163,163,7,4,11,1,1,14.82,11.61
613,Maharashtra,Indira Kala Sangit Vishwavidyalaya Khairagarh (Id: U0088),Acharya Bhatkhande Sangeet Mahavidyalaya LATUR  413 531 (Id: C33033),Latur,Technical/Polytechnic,0,0,0,0,0,0,1,0,0,3.34
614,Maharashtra,Kavi Kulguru Kalidas Sanskrit Vishwavidyalaya Ramtek (Id: U0310),Chintamani Vastushastra Padvika Mahavidyalaya Selu Kate (Id: C16239),Wardha,Technical/Polytechnic,1,0,1,1,0,1,0,1,1,3.67
615,Maharashtra,Kavi Kulguru Kalidas Sanskrit Vishwavidyalaya Ramtek (Id: U0310),Gurukrupa Mahavidyalaya Akola (Id: C16248),Akola,Technical/Polytechnic,74,46,120,11,6,17,1,0,7.06,5.69
616,Maharashtra,Kavi Kulguru Kalidas Sanskrit Vishwavidyalaya Ramtek (Id: U0310),Late. Nirmala Kashikar Sanskrit Pathashala and Mahavidyalaya Yavatmal (Id: C16208),Yavatmal,Technical/Polytechnic,0,17,17,0,0,0,1,0,0,3.34
617,Maharashtra,Kavi Kulguru Kalidas Sanskrit Vishwavidyalaya Ramtek (Id: U0310),L. K. Diploma Yogashastra Mahavidyalaya Gondiya (Id: C16206),Gondiya,Teacher Training,5,3,8,3,1,4,1,1,2,7.34
618,Maharashtra,Kavi Kulguru Kalidas Sanskrit Vishwavidyalaya Ramtek (Id: U0310),Nagaji Maharaj Mahavidyalaya Nagpur (Id: C16241),Nagpur,Teacher Training,3,1,4,0,10,10,0,0,0.4,0.14
619,Maharashtra,Kavi Kulguru Kalidas Sanskrit Vishwavidyalaya Ramtek (Id: U0310),Priyadarshini College Chandrapur (Id: C16251),Chandrapur,Technical/Polytechnic,16,32,48,0,6,6,0,0,8,2.67
620,Maharashtra,Kavi Kulguru Kalidas Sanskrit Vishwavidyalaya Ramtek (Id: U0310),Shree Samarth Ved Vidyalaya Dhalegaon Dist. Parbhani (Id: C16232),Parbhani,Technical/Polytechnic,53,0,53,10,1,11,1,1,4.82,8.28
621,Maharashtra,Kavi Kulguru Kalidas Sanskrit Vishwavidyalaya Ramtek (Id: U0310),Shri Suresh Yogshastra Mahavidyalaya Kamptee (Id: C16217),Nagpur,Teacher Training,0,0,0,0,0,0,1,0,0,3.34
622,Maharashtra,Kavi Kulguru Kalidas Sanskrit Vishwavidyalaya Ramtek (Id: U0310),Smt. Kanchantai Bhoyar Mahavidyalaya Hinganghat (Id: C16216),Wardha,Technical/Polytechnic,30,30,60,2,3,5,1,1,12,10.67
623,Maharashtra,Kavi Kulguru Kalidas Sanskrit Vishwavidyalaya Ramtek (Id: U0310),S.P. Bhoyar College Wardha (Id: C16257),Wardha,Technical/Polytechnic,15,26,41,2,14,16,1,0,2.57,4.19
624,Maharashtra,Kavi Kulguru Kalidas Sanskrit Vishwavidyalaya Ramtek (Id: U0310),Swami Kuvalyanand Mahavidyalaya Kolhapur (Id: C16222),Kolhapur,Teacher Training,0,0,0,0,0,0,1,1,0,6.67
625,Maharashtra,Kavi Kulguru Kalidas Sanskrit Vishwavidyalaya Ramtek (Id: U0310),Swami Vivekananda Shikshan Va Yoga Mahavidyalaya (Id: C16186),Bhandara,Teacher Training,34,4,38,4,0,4,0,1,9.5,6.5
626,Maharashtra,Kavi Kulguru Kalidas Sanskrit Vishwavidyalaya Ramtek (Id: U0310),Swami Vivekananda Shikshan Va Yoga Mahavidyalaya Sakoli (Id: C16186),Bhandara,Teacher Training,34,4,38,4,0,4,0,1,9.5,6.5
627,Maharashtra,Maharashtra University of Health Sciences Nashik (Id: U0313),Chaitany Welfare Charitable Trust s Bhakti Vedant Hospitals Institute of Nursing (P.B.B.Sc.) Meera Road (E) Dist. Thane (Id: C13737),Thane,Nursing,0,0,0,0,0,0,0,1,0,3.34
628,Maharashtra,Maharashtra University of Health Sciences Nashik (Id: U0313),Dnyanpath Bahuuddeshiya Shikshan Prasarak Mandals Suretech College of Nursing (B.Sc.) Jamtha Tal. Dist. Nagpur (Id: C13757),Nagpur,Nursing,0,0,0,0,0,0,0,1,0,3.34
629,Maharashtra,Mumbai University Mumbai (Id: U0318),Abhay Shikshan Kendras Krantijyoti Savitribai Phule College of Bachelor of Education Kannamwar Nagar No. 1 Vikroli (E) Mumbai 400 083 (Id: C33982),Mumbai Suburban,Teacher Training,13,81,94,0,8,8,1,1,11.75,10.59
630,Maharashtra,Mumbai University Mumbai (Id: U0318),Agnel Charitable Trusts Fr Conceicao Rodrigues Institute of Technology Sector 9A Vashi Navi Mumbai 400 703 (Id: C33530),Mumbai,Technical/Polytechnic,1017,470,1487,38,78,116,1,1,12.82,10.94
631,Maharashtra,Mumbai University Mumbai (Id: U0318),Gopaldas Jhamatmal Advani Law College 32nd Road Bandra (West) Mumbai 400 050 (Id: C34113),Mumbai Suburban,Teacher Training,358,445,803,14,15,29,1,0,27.69,12.57
632,Maharashtra,Mumbai University Mumbai (Id: U0318),Mahatma Education Society College of Education Chembur Naka Mumbai 400 071 (Id: C33801),Mumbai Suburban,Teacher Training,3,109,112,3,10,13,0,1,8.62,6.21
633,Maharashtra,Mumbai University Mumbai (Id: U0318),MANDAR EDUCATION SOCIETY’S SOU SHAILAJA SHINDE ARTS SCIENCE COMMERCE COLLEGE RAT0GIRI (Id: C45217),Ratnagiri,Teacher Training,77,33,110,1,9,10,0,0,11,3.67
634,Maharashtra,Mumbai University Mumbai (Id: U0318),National Institute for the Mentally Handicapped Fkat Bi B102 Vasundhara CHS Plot No 1314 Sector 8 Kharghar Navi Mumbai 410 210 (Id: C33642),Mumbai,Teacher Training,24,21,45,7,2,9,1,0,5,5
635,Maharashtra,Mumbai University Mumbai (Id: U0318),Navjeevan Education Societys College of Education (B.Ed.) Malegaon Dahivali Tal Karjat (Id: C33727),Raigarh,Teacher Training,27,52,79,4,3,7,1,1,11.29,10.43
636,Maharashtra,Mumbai University Mumbai (Id: U0318),Sahyadri Shikshan Sansthas B.A. Alias Bhaisaheb Sawant Adhyapak Mahavidyalaya Sawarde Taluka Chiplun Dist. Ratnagiri (Id: C33551),Ratnagiri,Teacher Training,32,55,87,5,2,7,1,0,12.43,7.48
637,Maharashtra,Mumbai University Mumbai (Id: U0318),Shanmukhananda Fine Arts and Sangeetha Sabha Bachelor of Fine Arts (Music) College Sion Mumbai 400 022 (Id: C33657),Mumbai,Teacher Training,5,3,8,0,2,2,0,1,4,4.67
638,Maharashtra,Mumbai University Mumbai (Id: U0318),Shree Narayana Mandir Samitis Sree Narayan Guru College of Education (B.Ed.) at Boria P L Lokhande Marg Chembur Mumbai 400 089 (Id: C33848),Mumbai Suburban,Teacher Training,0,0,0,0,0,0,0,1,0,3.34
639,Maharashtra,Mumbai University Mumbai (Id: U0318),Siddhivinayak Shikshan Prasarak Mandals R B B.Ed. College Ram Nagar Rawate Compound Tembe Pada Road Bhandup (East) Mumbai 400 078 (Id: C34010),Mumbai Suburban,Teacher Training,0,0,0,0,0,0,1,0,0,3.34
640,Maharashtra,North Maharashtra University Jalgaon (Id: U0320),200022K.S.WANI ADVANCED STUDY CENTRE IN MARATHI DHULE. (Id: C8892),Dhule,Technical/Polytechnic,50,0,50,10,0,10,0,1,5,5
641,Maharashtra,North Maharashtra University Jalgaon (Id: U0320),299997SATKARYOTEJAK SABHA'S BHARATIYA VIDYA SANSODHAN KENDRA DHULE. (Id: C9026),Dhule,Technical/Polytechnic,20,13,33,2,1,3,1,1,11,10.34
642,Maharashtra,Pune University Pune (Id: U0323),DR D Y PATIL EDUCATIO0L ENTERPRISES CHARITABLE TRUSTS DR D Y PATIL GROUP OF INSTITUTIONS DR D Y PATIL SCHOOL OF ENGINEERING AND TECHNOLOGY PUNE (Id: C45871),Pune,Technical/Polytechnic,294,41,335,36,23,59,1,1,5.68,8.56
643,Maharashtra,Pune University Pune (Id: U0323),DR D Y PATIL EDUCATIO0L ENTERPRISES CHARITABLE TRUSTS DR D Y PATIL GROUP OF INSTITUTIONS DR D Y PATIL SCHOOL OF ENGINEERING PUNE (Id: C46648),Pune,Technical/Polytechnic,613,194,807,44,18,62,1,0,13.02,7.68
644,Maharashtra,Pune University Pune (Id: U0323),Jagdamba Education Societys S.N.D.College of Education Babhulgaon Tal. Yeola Dist. Nashik 423401 (Id: C41636),Nashik,Teacher Training,0,0,0,0,0,0,1,1,0,6.67
645,Maharashtra,Pune University Pune (Id: U0323),K.E.M. Hospital Institute of Health Care ManagementSardar Mudliyar Marg Pune 411001 (Id: C42207),Pune,Technical/Polytechnic,11,39,50,4,7,11,1,0,4.55,4.85
646,Maharashtra,Pune University Pune (Id: U0323),Maharashtra Education Society's Abasaheb Garware College of Arts and Science Pune 04 (Id: C41477),Pune,Technical/Polytechnic,1815,1710,3525,57,52,109,1,0,32.34,14.12
647,Maharashtra,Pune University Pune (Id: U0323),Rajgad Dnyanpeeths Pharmacy College Bhor Dist. Pune (Id: C41335),Pune,Technical/Polytechnic,53,47,100,11,5,16,1,0,6.25,5.42
648,Maharashtra,Pune University Pune (Id: U0323),Sancheti Institute for Orthopaedics and Rehabilitation Shivajinagar Pune 411005 (Id: C41610),Pune,Technical/Polytechnic,0,0,0,0,0,0,0,1,0,3.34
649,Maharashtra,Pune University Pune (Id: U0323),Shri Swarajya Education Societys Swarajya School of Management Krushnabhai Gruharachana Societys Dhankawadi Pune 411043 (Id: C41609),Pune,Technical/Polytechnic,9,3,12,2,1,3,0,0,4,1.34
650,Maharashtra,Rashtrasant Tukadoji Maharaj Nagpur University Nagpur (Id: U0332),Chintamani B Ed College Ballarpur (Id: C18334),Chandrapur,Teacher Training,48,26,74,8,0,8,0,1,9.25,6.42
651,Maharashtra,Rashtrasant Tukadoji Maharaj Nagpur University Nagpur (Id: U0332),Kinkar Education College Selu (Id: C18927),Wardha,Teacher Training,34,73,107,3,2,5,1,0,21.4,10.47
652,Maharashtra,Rashtrasant Tukadoji Maharaj Nagpur University Nagpur (Id: U0332),Mahmud Ali College of Education Kamptee (Id: C18520),Nagpur,Teacher Training,11,88,99,1,5,6,1,0,16.5,8.84
653,Maharashtra,Rashtrasant Tukadoji Maharaj Nagpur University Nagpur (Id: U0332),Sharadchandra Pawar Arts College Charmoshi (Id: C18606),Gadchiroli,Teacher Training,0,163,163,7,4,11,0,0,14.82,4.94
654,Maharashtra,Sant Gadge Baba Amravati University Amravati (Id: U0324),College of Physical Education Karanja (Lad). (Id: C43211),Washim,Teacher Training,54,4,58,5,0,5,1,0,11.6,7.2
655,Maharashtra,Sant Gadge Baba Amravati University Amravati (Id: U0324),Gunwantrao Deshmush Education College. Pusad (Id: C42987),Yavatmal,Teacher Training,0,0,0,0,0,0,0,1,0,3.34
656,Maharashtra,Sant Gadge Baba Amravati University Amravati (Id: U0324),Jijau Education College Yavatmal (Id: C43001),Yavatmal,Teacher Training,14,56,70,4,2,6,1,0,11.67,7.23
657,Maharashtra,Sant Gadge Baba Amravati University Amravati (Id: U0324),Late Govindrao Patil Education College Darwha. (Id: C42918),Yavatmal,Teacher Training,35,65,100,1,4,5,0,1,20,10
658,Maharashtra,Sant Gadge Baba Amravati University Amravati (Id: U0324),Shinde B.Ed. College Anjani Bu. Mehakar (Id: C43104),Buldana,Teacher Training,0,0,0,0,0,0,1,0,0,3.34
659,Maharashtra,Shivaji University Kolhapur (Id: U0325),Anandi Arts Commerce and Science College Gaganbavada (Id: C11145),Kolhapur,Teacher Training,619,87,706,28,9,37,1,0,19.09,9.7
660,Maharashtra,Shivaji University Kolhapur (Id: U0325),Appasaheb Birnale College of Education (Id: C11126),Sangli,Teacher Training,17,78,95,3,8,11,0,1,8.64,6.22
661,Maharashtra,Shivaji University Kolhapur (Id: U0325),Mahadevrao B.Ed. College Turkewadi (Id: C11213),Kolhapur,Teacher Training,0,0,0,0,0,0,0,1,0,3.34
662,Maharashtra,Shivaji University Kolhapur (Id: U0325),Shikshanshastra Mahavidyalaya VITA (Id: C10992),Sangli,Teacher Training,54,81,135,3,5,8,0,1,16.88,8.96
663,Maharashtra,Shivaji University Kolhapur (Id: U0325),Yashoda Technical campus Faculty of Engineering Wadhe (Id: C11075),Satara,Technical/Polytechnic,13,17,30,1,0,1,1,1,30,16.67
664,Maharashtra,Solapur University Solapur (Id: U0327),PARVATI TAD EDUCATION COLLEGE  MAGALWEDHA TAL.MAGLWADH DISTSOLAPUR (Id: C15685),Solapur,Teacher Training,0,0,0,0,0,0,1,1,0,6.67
665,Maharashtra,Solapur University Solapur (Id: U0327),SHRI VIRATAPSVI CHAN0VIR SHIVACHARY EDUCATION COLLEGE MIDC AKKLKOT ROAD SOLAPUR DISTSOLAPUR (Id: C15702),Solapur,Teacher Training,36,26,62,6,2,8,0,1,7.75,5.92
666,Maharashtra,Solapur University Solapur (Id: U0327),UMA COLLEGE OF EDUCATION COLLEGE PANDHARPUR TAL.PANDHARPUR DISTSOLAPUR (Id: C15773),Solapur,Teacher Training,27,25,52,5,1,6,1,0,8.67,6.23
667,Maharashtra,Swami Ramanand Teerth Marathwada University Nanded (Id: U0328),Manavendra Kendre Adhyapak Mahavidyalaya Jalkot (Id: C7608),Latur,Teacher Training,81,19,100,6,2,8,1,0,12.5,7.5
668,Maharashtra,Swami Ramanand Teerth Marathwada University Nanded (Id: U0328),Pradnya Pratishtan's Adhyaapak MahavidyalayaPurna Road Nanded (Id: C7321),Nanded,Teacher Training,0,0,0,0,0,0,0,1,0,3.34
669,Maharashtra,Swami Ramanand Teerth Marathwada University Nanded (Id: U0328),Shri Shivaji Law College Vasmat Road Parbhani (Id: C7451),Parbhani,Technical/Polytechnic,0,0,0,0,0,0,1,0,0,3.34
670,Manipur,Manipur University Imphal (Id: U0337),Government Polytechnic (Id: C9425),Imphal West,Technical/Polytechnic,285,99,384,24,12,36,0,0,10.67,3.56
671,Meghalaya,North Eastern Hill University Shillong (Id: U0341),College of Teacher Education (PGT) (Id: C16347),East Khasi Hills,Teacher Training,41,55,96,7,11,18,1,0,5.34,5.12
672,Odisha,Biju Patnaik University of Technology Rourkela (Id: U0351),Jeypore College of Pharmacy (JCP) Jeypore (Id: C30073),Gajapati,Technical/Polytechnic,178,48,226,21,6,27,0,1,8.38,6.13
673,Odisha,Sambalpur University Sambalpur (Id: U0362),College of Teacher Education (Id: C43406),Balangir,Teacher Training,52,46,98,2,2,4,0,0,24.5,8.17
674,Punjab,Baba Farid University of Health and Medical Sciences Faridkot (Id: U0371),BABA MANGAL SINGH NURSING INSTITUTE BAR0LA ROAD BUGHIPURA (Id: C49590),Moga,Nursing,73,163,236,7,31,38,0,1,6.22,5.41
675,Punjab,Baba Farid University of Health and Medical Sciences Faridkot (Id: U0371),DAV Institute of Physiotherapy and Rehabilitation MHRM G.T. Road Jalandhar (Id: C29142),Jalandhar,Technical/Polytechnic,0,0,0,0,0,0,0,1,0,3.34
676,Punjab,Baba Farid University of Health and Medical Sciences Faridkot (Id: U0371),University College of Nursing Faridkot (Id: C29137),Faridkot,Nursing,0,0,0,0,0,0,1,0,0,3.34
677,Punjab,Baba Farid University of Health and Medical Sciences Faridkot (Id: U0371),VMS College of Nursing and Paramedical Sciences Said Mubarak Amritsar Road Batala (Id: C29134),Gurdaspur,Nursing,2,53,55,0,7,7,0,0,7.86,2.62
678,Punjab,Guru Nanak Dev University Amritsar (Id: U0376),Govt. College Ajnala (Distt. Amritsar) (Id: C27999),Amritsar,Technical/Polytechnic,287,133,420,8,6,14,0,1,30,13.34
679,Punjab,Punjabi University Patiala (Id: U0383),Desh Bhagat Institute of Management and Computer Sciences Mandi Gobindgarh Fatehgarh Sahib (Id: C22249),Fatehgarh Sahib,Technical/Polytechnic,474,376,850,46,46,92,1,1,9.24,9.75
680,Punjab,Punjabi University Patiala (Id: U0383),Mastermind College of Education Bathinda (Id: C22248),Bathinda,Teacher Training,55,145,200,6,14,20,1,1,10,10
681,Punjab,Punjabi University Patiala (Id: U0383),0VJIVINI INSTITUTE OF SPECIAL EUCATION AND RESEARCH SULAR (Id: C47293),Patiala,Teacher Training,34,37,71,3,10,13,1,0,5.47,5.16
682,Punjab,Punjab Technical University Jalandhar (Id: U0382),Desh Bhagat Foundation gruoup of Institutions Moga (Id: C10367),Moga,Technical/Polytechnic,0,0,0,0,0,0,0,0,0,0
683,Rajasthan,Jagadguru Ramanandacharya Rajasthan Sanskrit University Jaipur (Id: U0397),Shrimati Ramkumari TT College (Id: C26608),Jhunjhunun,Teacher Training,0,0,0,0,0,0,1,0,0,3.34
684,Rajasthan,Jai Narain Vyas University Jodhpur (Id: U0399),Adarsh Mahila Shikshak Prashikshan Mahavidyalaya Bilara (Id: C13120),Jodhpur,Teacher Training,0,792,792,13,4,17,1,1,46.59,22.2
685,Rajasthan,Jai Narain Vyas University Jodhpur (Id: U0399),Peepar Teachers Training College Peepar City (Id: C13046),Jodhpur,Teacher Training,80,19,99,5,5,10,1,1,9.9,9.97
686,Rajasthan,Kota University Kota (Id: U0387),Hitkari Mahila T.T. College Garh Palace Kota (Id: C19476),Kota,Teacher Training,0,118,118,2,7,9,0,1,13.12,7.71
687,Rajasthan,Kota University Kota (Id: U0387),Maharaja Mool Singh Degree College Lakheri Bundi (Id: C19375),Bundi,Technical/Polytechnic,78,161,239,12,2,14,1,1,17.08,12.36
688,Rajasthan,Kota University Kota (Id: U0387),Millinium T.T. College Aklera Jhalawar (Id: C19479),Jhalawar,Teacher Training,77,23,100,3,5,8,1,0,12.5,7.5
689,Rajasthan,Kota University Kota (Id: U0387),Prashanti T.T. College Mahaveer Nagar Kota (Id: C19457),Kota,Teacher Training,0,100,100,0,8,8,0,1,12.5,7.5
690,Rajasthan,Kota University Kota (Id: U0387),Ramanand T.T. CollegeMahaveer Colony Rangpur Road Station Kota (Id: C19357),Kota,Teacher Training,61,39,100,5,4,9,1,1,11.12,10.38
691,Rajasthan,Maharaja Ganga Singh University Bikaner (Id: U0406),Abhilasha T.T.College Sahwa (Id: C40654),Churu,Teacher Training,159,41,200,13,3,16,0,1,12.5,7.5
692,Rajasthan,Maharaja Ganga Singh University Bikaner (Id: U0406),Dev T.T. College Taranagar (Id: C40627),Churu,Teacher Training,59,35,94,5,3,8,0,0,11.75,3.92
693,Rajasthan,Maharaja Ganga Singh University Bikaner (Id: U0406),India Mahila T.T. College Ratangarh (Id: C40745),Churu,Teacher Training,0,100,100,3,5,8,1,0,12.5,7.5
694,Rajasthan,Maharaja Ganga Singh University Bikaner (Id: U0406),Kothari T.T. College Sankhan Tal (Id: C40781),Churu,Teacher Training,52,47,99,6,2,8,0,1,12.38,7.46
695,Rajasthan,Maharaja Ganga Singh University Bikaner (Id: U0406),Maharshi Dayanand B.Ed. College Sriganganagar (Id: C40788),Ganganagar,Teacher Training,50,50,100,3,7,10,0,1,10,6.67
696,Rajasthan,Maharaja Ganga Singh University Bikaner (Id: U0406),Malaram T.T. College Sankhan Tal (Id: C40792),Churu,Teacher Training,66,26,92,5,3,8,1,1,11.5,10.5
697,Rajasthan,Maharaja Ganga Singh University Bikaner (Id: U0406),M.D.M. CoEducation B.Ed. College 12 T.K. Raisinghnagar (Id: C40772),Ganganagar,Teacher Training,0,0,0,0,0,0,0,1,0,3.34
698,Rajasthan,Maharaja Ganga Singh University Bikaner (Id: U0406),Murtidevi Memorial B.Ed. College Chak 4 SDS Sadulsahshar (Id: C40676),Ganganagar,Teacher Training,118,81,199,6,9,15,1,0,13.27,7.76
699,Rajasthan,Maharaja Ganga Singh University Bikaner (Id: U0406),Sant Nekiram T.T.College Sitsar (Id: C40780),Churu,Teacher Training,42,29,71,8,4,12,1,1,5.92,8.64
700,Rajasthan,Maharaja Ganga Singh University Bikaner (Id: U0406),Seth Dharmchand Insttute of Teachers Training Raisinghnagar (Id: C40656),Ganganagar,Teacher Training,62,38,100,4,4,8,1,1,12.5,10.84
701,Rajasthan,Maharaja Ganga Singh University Bikaner (Id: U0406),Seth Sushil Kumar Bihani S. D. T.T. College (Id: C36657),Ganganagar,Teacher Training,84,108,192,4,7,11,1,1,17.46,12.49
702,Rajasthan,Maharaja Ganga Singh University Bikaner (Id: U0406),Shubhash Chandra Bose T.T. College Sahwa (Id: C40614),Churu,Teacher Training,60,38,98,4,4,8,1,1,12.25,10.75
703,Rajasthan,Maharaja Ganga Singh University Bikaner (Id: U0406),Tagore Mahila T.T. College Suratgarh (Id: C40742),Ganganagar,Teacher Training,0,100,100,3,5,8,0,1,12.5,7.5
704,Rajasthan,Maharishi Dayanand Saraswati University Ajmer (Id: U0408),Central Academy Teachers Training College (Id: C13064),Ajmer,Teacher Training,138,57,195,1,13,14,1,1,13.93,11.31
705,Rajasthan,Maharishi Dayanand Saraswati University Ajmer (Id: U0408),Peepar Teachers Training College Peepar City (Id: C13046),Jodhpur,Teacher Training,80,19,99,5,5,10,1,0,9.9,6.64
706,Rajasthan,Maharishi Dayanand Saraswati University Ajmer (Id: U0408),Shri Ganesh Chandra T.T. College Jas Nagar Merta City (Id: C30877),Nagaur,Teacher Training,85,15,100,10,1,11,1,0,9.1,6.37
707,Rajasthan,Mohan Lal Sukhadia University Uaipur (Id: U0413),B.N. P.G. GIRLS COLLEGE (Id: C39893),Udaipur,Technical/Polytechnic,0,0,0,0,0,0,1,1,0,6.67
708,Rajasthan,Rajasthan Ayurveda University Jodhpur (Id: U0418),Aditi Vikas Ayurved Nursing Training Centre Sikar (Id: C26211),Sikar,Nursing,27,36,63,6,3,9,1,0,7,5.67
709,Rajasthan,Rajasthan Ayurveda University Jodhpur (Id: U0418),Ambika Vikas Sansthan Ayurved Nursing Training Centre Jodhpur (Id: C26203),Jodhpur,Nursing,59,42,101,8,0,8,1,1,12.63,10.88
710,Rajasthan,Rajasthan Ayurveda University Jodhpur (Id: U0418),Arihan Ayurved Nursing Training Centre Kota (Id: C26237),Kota,Nursing,57,30,87,9,0,9,1,1,9.67,9.89
711,Rajasthan,Rajasthan Ayurveda University Jodhpur (Id: U0418),Ayurved Nursing Training CentreNational Institute Of Ayurveda Jaipur (Id: C26240),Jaipur,Nursing,40,49,89,61,13,74,0,0,1.21,0.41
712,Rajasthan,Rajasthan Ayurveda University Jodhpur (Id: U0418),Baba Narayandas Ayurved Nursing Training Centre Jhunjhunu (Id: C26244),Jhunjhunun,Nursing,27,10,37,6,1,7,0,1,5.29,5.1
713,Rajasthan,Rajasthan Ayurveda University Jodhpur (Id: U0418),Bharti Bal Mandir Samiti Ayurved Nursing Training Centre Jaipur (Id: C26230),Jaipur,Nursing,10,10,20,9,0,9,0,0,2.23,0.75
714,Rajasthan,Rajasthan Ayurveda University Jodhpur (Id: U0418),B.M. Education Foundation Trust Ayurved Nursing Training Centre Pilani (Id: C26224),Jhunjhunun,Nursing,20,13,33,8,0,8,0,1,4.13,4.71
715,Rajasthan,Rajasthan Ayurveda University Jodhpur (Id: U0418),Choudhary Charansingh Medical S.P.S. Ayurved Nursing TrainingAlwar Centre Alwar (Id: C26227),Alwar,Nursing,77,22,99,10,0,10,0,0,9.9,3.3
716,Rajasthan,Rajasthan Ayurveda University Jodhpur (Id: U0418),Dhanwantri Ayurved Nursing Training Centre Sikar (Id: C26245),Sikar,Nursing,54,40,94,10,0,10,1,1,9.4,9.8
717,Rajasthan,Rajasthan Ayurveda University Jodhpur (Id: U0418),Government Ayurved Nurse Compounder Training Centre Jodhpur (Id: C26220),Jodhpur,Nursing,123,46,169,5,4,9,0,0,18.78,6.26
718,Rajasthan,Rajasthan Ayurveda University Jodhpur (Id: U0418),Government Ayurved Nursing Training Centre and Affilated Hospital Ajmer (Id: C26242),Ajmer,Nursing,89,83,172,4,3,7,1,0,24.58,11.53
719,Rajasthan,Rajasthan Ayurveda University Jodhpur (Id: U0418),G.T. Ayurved Unani Institute Research Centre Nursing Training Centre Alwar (Id: C26239),Alwar,Nursing,46,33,79,8,1,9,1,0,8.78,6.26
720,Rajasthan,Rajasthan Ayurveda University Jodhpur (Id: U0418),Kala Asram Ayurved Nursing Training Centre Udaipur (Id: C26238),Udaipur,Nursing,20,20,40,7,2,9,1,0,4.45,4.82
721,Rajasthan,Rajasthan Ayurveda University Jodhpur (Id: U0418),Madhuban Shikshan Sansthan Ayurved Nursing TrainingCentre Jodhpur (Id: C26212),Jodhpur,Nursing,52,18,70,5,4,9,0,0,7.78,2.6
722,Rajasthan,Rajasthan Ayurveda University Jodhpur (Id: U0418),Mahatma Jyotiba Phoole Ayurved Nursing Training CentreChaumu (Id: C26216),Jaipur,Nursing,86,34,120,9,1,10,0,1,12,7.34
723,Rajasthan,Rajasthan Ayurveda University Jodhpur (Id: U0418),Marwar Health Care Society Ayurved Nursing Training CentreKuchaman City (Id: C26235),Nagaur,Nursing,62,42,104,10,0,10,1,1,10.4,10.14
724,Rajasthan,Rajasthan Ayurveda University Jodhpur (Id: U0418),Mewar Education Society Ayurved Nursing Training Center Chittorgarh (Id: C26207),Chittaurgarh,Nursing,0,132,132,5,2,7,0,0,18.86,6.29
725,Rajasthan,Rajasthan Ayurveda University Jodhpur (Id: U0418),Naurang Ram Dayanand Dhukiya Ayurved Nursing Training Centre Jhunjhunu (Id: C26205),Jhunjhunun,Nursing,0,0,0,0,0,0,0,0,0,0
726,Rajasthan,Rajasthan Ayurveda University Jodhpur (Id: U0418),Om Shiv Ayurved Nursing Training CentreMangalwad Choraha (Id: C26215),Chittaurgarh,Nursing,12,14,26,7,1,8,1,1,3.25,7.75
727,Rajasthan,Rajasthan Ayurveda University Jodhpur (Id: U0418),Rajeev Gandhi Ayurved Nursing Training CentreHindaun City (Id: C26228),Karauli,Nursing,68,45,113,9,0,9,0,0,12.56,4.19
728,Rajasthan,Rajasthan Ayurveda University Jodhpur (Id: U0418),Rajeev Gandhi Ayurved Nursing Training Centre Kota (Id: C26222),Kota,Nursing,0,0,0,0,0,0,0,0,0,0
729,Rajasthan,Rajasthan Ayurveda University Jodhpur (Id: U0418),Sarvodaya Ayurved Nursing Training Centre Bundi (Id: C26232),Bundi,Nursing,0,0,0,0,0,0,1,1,0,6.67
730,Rajasthan,Rajasthan Ayurveda University Jodhpur (Id: U0418),Shivpyari Ruthala Ayurved Vikas SansthanAyurved Nursing Training CenterNawalgarh (Id: C26225),Jhunjhunun,Nursing,25,15,40,11,0,11,1,1,3.64,7.88
731,Rajasthan,Rajasthan Ayurveda University Jodhpur (Id: U0418),Shri J.R. Tantia Ayurved Nursing Training Centre Shriganganagar (Id: C26209),Ganganagar,Nursing,76,29,105,8,1,9,0,1,11.67,7.23
732,Rajasthan,Rajasthan Ayurveda University Jodhpur (Id: U0418),Shri Ram Ayurved Nursing Training CentreBagrawa Kanota (Id: C26218),Jaipur,Nursing,8,2,10,6,4,10,0,0,1,0.34
733,Rajasthan,Rajasthan Ayurveda University Jodhpur (Id: U0418),Sushrut Ayurved Nursing Training Centre Baran (Id: C26204),Baran,Nursing,79,34,113,9,0,9,1,1,12.56,10.86
734,Rajasthan,Rajasthan Ayurveda University Jodhpur (Id: U0418),Ummed Singh Bhati Ayurved Nursing Training CentreAbu Road (Id: C26214),Sirohi,Nursing,74,29,103,9,0,9,0,0,11.45,3.82
735,Rajasthan,Rajasthan Ayurveda University Jodhpur (Id: U0418),University Ayurved Nursing Training Centre Jodhpur (Id: C26246),Jodhpur,Nursing,62,37,99,8,4,12,0,0,8.25,2.75
736,Rajasthan,Rajasthan Ayurveda University Jodhpur (Id: U0418),Upchar Medicare Society Ayurved Nursing Training Centre Jaipur (Id: C26219),Jaipur,Nursing,19,9,28,8,1,9,0,1,3.12,4.38
737,Rajasthan,Rajasthan University Jaipur (Id: U0422),Balaji T T College Jhunjhunun (Id: C39142),Jhunjhunun,Teacher Training,46,54,100,8,0,8,0,0,12.5,4.17
738,Rajasthan,Rajasthan University Jaipur (Id: U0422),Bhanwar Kanwar Sugan Singh Shiksha Mahavi. Jhunjhunun (Id: C38509),Jhunjhunun,Teacher Training,74,26,100,3,5,8,1,0,12.5,7.5
739,Rajasthan,Rajasthan University Jaipur (Id: U0422),B S Memorial B.Ed. College Sikar (Id: C38483),Sikar,Teacher Training,45,55,100,8,0,8,1,0,12.5,7.5
740,Rajasthan,Rajasthan University Jaipur (Id: U0422),Cambridge Court College of Edu. Jaipur (Id: C38384),Jaipur,Teacher Training,0,0,0,0,0,0,0,0,0,0
741,Rajasthan,Rajasthan University Jaipur (Id: U0422),Indian Girls College of Edu. Jhunjhunun (Id: C38476),Jhunjhunun,Teacher Training,0,0,0,0,0,0,0,0,0,0
742,Rajasthan,Rajasthan University Jaipur (Id: U0422),Lord's International College for Teachers Training Alwar (Id: C38784),Alwar,Teacher Training,108,83,191,6,11,17,0,1,11.24,7.08
743,Rajasthan,Rajasthan University Jaipur (Id: U0422),Manu Oxfordt TT College Jhunjhunun (Id: C39033),Jhunjhunun,Teacher Training,0,0,0,0,0,0,1,1,0,6.67
744,Rajasthan,Rajasthan University Jaipur (Id: U0422),MKB Mahila B.Ed. Mahavi. Jaipur (Id: C38793),Jaipur,Teacher Training,97,0,97,9,0,9,1,0,10.78,6.93
745,Rajasthan,Rajasthan University Jaipur (Id: U0422),Modern TT CDollege Jhunjhunun (Id: C38877),Jhunjhunun,Teacher Training,0,0,0,0,0,0,0,0,0,0
746,Rajasthan,Rajasthan University Jaipur (Id: U0422),Neelkanth TT College Jhunjhunun (Id: C38567),Jhunjhunun,Teacher Training,18,38,56,6,1,7,0,0,8,2.67
747,Rajasthan,Rajasthan University Jaipur (Id: U0422),New Rajasthan Women TT College Jhunjhunun (Id: C38599),Jhunjhunun,Teacher Training,0,100,100,2,6,8,0,1,12.5,7.5
748,Rajasthan,Rajasthan University Jaipur (Id: U0422),Rao B.Ed. College Alwar (Id: C39151),Alwar,Teacher Training,70,30,100,5,3,8,1,1,12.5,10.84
749,Rajasthan,Rajasthan University Jaipur (Id: U0422),Shadi Lal Kataria Memorial Women's TT College Jhunjhunun (Id: C38361),Jhunjhunun,Teacher Training,0,0,0,0,0,0,1,0,0,3.34
750,Rajasthan,Rajasthan University Jaipur (Id: U0422),Shaurya Edu. Inst. Bhartpur (Id: C39070),Bharatpur,Teacher Training,0,0,0,0,0,0,0,1,0,3.34
751,Rajasthan,Rajasthan University Jaipur (Id: U0422),Shekhawati Mahila Shikshak Prashikshan Mahavi. Sikar (Id: C38871),Sikar,Teacher Training,0,98,98,1,0,1,0,1,98,36
752,Rajasthan,Rajasthan University Jaipur (Id: U0422),Shekhawati TT College. Jhunjhunun (Id: C39080),Jhunjhunun,Teacher Training,0,0,0,0,0,0,1,0,0,3.34
753,Rajasthan,Rajasthan University Jaipur (Id: U0422),Shri Nathmal Todi B.Ed. College Sikar (Id: C38441),Sikar,Teacher Training,65,34,99,4,4,8,1,0,12.38,7.46
754,Rajasthan,Rajasthan University Jaipur (Id: U0422),Shri Rishikul B.Ed. College Sikar (Id: C38577),Sikar,Teacher Training,48,52,100,5,3,8,1,0,12.5,7.5
755,Rajasthan,Rajasthan University Jaipur (Id: U0422),Smt. Ramkumari TT College Jhunjhunun (Id: C38462),Jhunjhunun,Teacher Training,0,0,0,0,0,0,1,1,0,6.67
756,Rajasthan,Rajasthan University Jaipur (Id: U0422),SS Jain Subodh Mahila TT college Jaipur (Id: C38912),Jaipur,Teacher Training,0,232,232,1,18,19,0,1,12.22,7.41
757,Rajasthan,Rajasthan University Jaipur (Id: U0422),Sunrise Gurukul TT College Sikar (Id: C38763),Sikar,Teacher Training,57,43,100,8,0,8,1,0,12.5,7.5
758,Rajasthan,Rajasthan University Jaipur (Id: U0422),Trilok Singh TT College Sikar (Id: C39139),Sikar,Teacher Training,36,29,65,3,3,6,1,0,10.84,6.95
759,Rajasthan,Rajasthan University Jaipur (Id: U0422),Yaduvanshi College of EducationJhunjhunun (Id: C38951),Jhunjhunun,Teacher Training,72,125,197,11,4,15,0,0,13.14,4.38
760,Rajasthan,Rajasthan University of Health Sciences Jaipur (Id: U0420),AKASHDEEP COLLEGE OF PHARMACY JAIPUR (Id: C47087),Jaipur,Technical/Polytechnic,109,9,118,7,1,8,1,1,14.75,11.59
761,Rajasthan,Rajasthan University of Health Sciences Jaipur (Id: U0420),KRISH0 DEVI MAHESWARI PHARMACY COLLEGE JHUNJHUNU (Id: C47146),Jhunjhunun,Technical/Polytechnic,98,18,116,10,1,11,1,0,10.55,6.85
762,Rajasthan,Rajasthan University of Health Sciences Jaipur (Id: U0420),NEHRU MEMORIAL COLLEGE OF PHARMACY HANUMANGARH (Id: C47083),Hanumangarh,Technical/Polytechnic,87,9,96,5,0,5,0,1,19.2,9.74
763,Rajasthan,Rajasthan University of Health Sciences Jaipur (Id: U0420),PARMA0ND COLLEGE OF TECHNOLOGY SRIGANGA0GAR (Id: C47226),Ganganagar,Technical/Polytechnic,79,6,85,7,0,7,1,0,12.15,7.39
764,Rajasthan,Rajasthan University of Health Sciences Jaipur (Id: U0420),R R COLLEGE OF NURSING AJMER (Id: C47045),Ajmer,Nursing,211,90,301,21,17,38,1,0,7.93,5.98
765,Rajasthan,Rajasthan University of Health Sciences Jaipur (Id: U0420),SHRI BAJRANG COLLEGE OF PHARMACY BHARATPUR (Id: C47060),Bharatpur,Technical/Polytechnic,69,4,73,7,0,7,1,1,10.43,10.15
766,Rajasthan,Rashtriya Sanskrit Sansthan New Delhi (Id: U0115),JAIPUR CAMPUS (Id: C27021),Jaipur,Teacher Training,0,0,0,0,0,0,1,0,0,3.34
767,Tamil Nadu,Anna University Chennai (Id: U0439),Aksheyaa College of Engineering (Id: C16574),Kancheepuram,Technical/Polytechnic,802,206,1008,0,0,0,0,0,0,0
768,Tamil Nadu,Anna University Chennai (Id: U0439),Coimbatore Institute of Technology (Id: C36969),Coimbatore,Technical/Polytechnic,1943,1175,3118,119,134,253,1,0,12.33,7.45
769,Tamil Nadu,Anna University Chennai (Id: U0439),Maria College of Engineering and Technology (Id: C27028),Kanniyakumari,Technical/Polytechnic,954,445,1399,77,24,101,1,1,13.86,11.29
770,Tamil Nadu,Anna University Chennai (Id: U0439),P.A.College of Engineering and Technology (Id: C37041),Coimbatore,Technical/Polytechnic,1011,747,1758,73,48,121,1,0,14.53,8.18
771,Tamil Nadu,Anna University Chennai (Id: U0439),SCAD College of Engineering and Technology (Id: C27048),Tirunelveli,Technical/Polytechnic,1154,700,1854,81,92,173,1,1,10.72,10.24
772,Tamil Nadu,Anna University Chennai (Id: U0439),UNIVERSAL COLLEGE OF ENGINEERING TECHNOLOGY TIRUNELVELI (Id: C45260),Tirunelveli,Technical/Polytechnic,319,47,366,18,19,37,1,0,9.9,6.64
773,Tamil Nadu,Anna University Coimbatore (Id: U0440),Coimbatore Institute of Technology (Id: C36969),Coimbatore,Technical/Polytechnic,1943,1175,3118,119,134,253,1,1,12.33,10.78
774,Tamil Nadu,Anna University Coimbatore (Id: U0440),P.A.College of Engineering and Technology (Id: C37041),Coimbatore,Technical/Polytechnic,1011,747,1758,73,48,121,0,0,14.53,4.85
775,Tamil Nadu,Anna University of Technology Tirunelveli (Id: U0442),Maria College of Engineering and Technology (Id: C27028),Kanniyakumari,Technical/Polytechnic,954,445,1399,77,24,101,0,0,13.86,4.62
776,Tamil Nadu,Anna University of Technology Tirunelveli (Id: U0442),SCAD College of Engineering and Technology (Id: C27048),Tirunelveli,Technical/Polytechnic,1154,700,1854,81,92,173,1,1,10.72,10.24
777,Tamil Nadu,Anna University of Technology Tirunelveli (Id: U0442),UNIVERSAL COLLEGE OF ENGINEERING TECHNOLOGY TIRUNELVELI (Id: C45260),Tirunelveli,Technical/Polytechnic,319,47,366,18,19,37,1,0,9.9,6.64
778,Tamil Nadu,Bharathidasan University Tiruchirappalli (Id: U0448),Annai College of Arts and Science Kumbakonam612 503. (Id: C35839),Thanjavur,Technical/Polytechnic,0,0,0,0,0,0,1,1,0,6.67
779,Tamil Nadu,Bharathidasan University Tiruchirappalli (Id: U0448),A.V.V.M. Sri Pushpam College Poondi  613 503. (Id: C35899),Thiruvarur,Technical/Polytechnic,2849,5155,8004,368,288,656,0,1,12.21,7.41
780,Tamil Nadu,Bharathidasan University Tiruchirappalli (Id: U0448),Cauvery Institute of Technology 758 South Iyyampatty Mullur Pudukkottai  622 004 (Id: C35887),Pudukkottai,Technical/Polytechnic,0,0,0,0,0,0,1,0,0,3.34
781,Tamil Nadu,Bharathidasan University Tiruchirappalli (Id: U0448),Sri Pushpam Institute of Vocational Education and Training 13 V.O.C. Nagar First Street Thanjavur  613 007 (Id: C35819),Thanjavur,Technical/Polytechnic,0,87,87,1,4,5,1,0,17.4,9.14
782,Tamil Nadu,Bharathidasan University Tiruchirappalli (Id: U0448),Sri Renganatha Paduka Vidyalaya Tiruchirappalli  620 006 (Id: C35797),Tiruchirappalli,Technical/Polytechnic,18,0,18,4,0,4,0,1,4.5,4.84
783,Tamil Nadu,Bharathidasan University Tiruchirappalli (Id: U0448),Uswathun Hasana Oriental Arabic College Pallapatti  639 205 (Id: C35870),Karur,Technical/Polytechnic,92,55,147,5,5,10,0,0,14.7,4.9
784,Tamil Nadu,Madurai Kamraj University Madurai (Id: U0463),AKILIKA HERBAL INSTITUTE (Id: C36528),Dindigul,Technical/Polytechnic,8,9,17,3,2,5,1,0,3.4,4.47
785,Tamil Nadu,Madurai Kamraj University Madurai (Id: U0463),AMBIGA COLLEGE OF ARTS and SCIENCE (Id: C36491),Madurai,Teacher Training,0,0,0,0,0,0,0,1,0,3.34
786,Tamil Nadu,Madurai Kamraj University Madurai (Id: U0463),COLLEGE OF GANDHIAN THOUGHT (Id: C36535),Madurai,Technical/Polytechnic,11,5,16,2,2,4,0,1,4,4.67
787,Tamil Nadu,Madurai Kamraj University Madurai (Id: U0463),INSTITUTE OF GANDHIAN STSUDIES and RESEARCH (Id: C36492),Madurai,Technical/Polytechnic,72,43,115,5,8,13,0,0,8.85,2.95
788,Tamil Nadu,Madurai Kamraj University Madurai (Id: U0463),MEE0KSHI MISSION HOSPITAL and RESEARCH CENTRE (Id: C36580),Madurai,Technical/Polytechnic,0,0,0,0,0,0,1,0,0,3.34
789,Tamil Nadu,Madurai Kamraj University Madurai (Id: U0463),RAJ INSTITUTE OF INFORMATION TECHNOLOGY (RAJIIT) (Id: C36554),Madurai,Technical/Polytechnic,0,0,0,0,0,0,0,1,0,3.34
790,Tamil Nadu,Madurai Kamraj University Madurai (Id: U0463),SATHANGAI ACADEMY (Id: C36496),Madurai,Technical/Polytechnic,10,30,40,1,2,3,0,1,13.34,7.78
791,Tamil Nadu,Madurai Kamraj University Madurai (Id: U0463),TAMIL0DU THEOLOGICAL SEMI0RY (Id: C36516),Madurai,Technical/Polytechnic,45,30,75,15,7,22,1,0,3.41,4.47
792,Tamil Nadu,Madurai Kamraj University Madurai (Id: U0463),T.V.S. EDUCATIO0L RESEARCH AND DEVELOPMENT CENTRE (Id: C36560),Madurai,Technical/Polytechnic,0,0,0,0,0,0,1,1,0,6.67
793,Tamil Nadu,Madurai Kamraj University Madurai (Id: U0463),WASH INSTITUTE (Id: C36563),Dindigul,Technical/Polytechnic,20,10,30,2,1,3,0,1,10,6.67
794,Tamil Nadu,Tamilnadu Agricultural University Coimbatore (Id: U0485),Agricultural College and Research Institute Thoothukkudi (Id: C44918),Thoothukkudi,Technical/Polytechnic,166,196,362,66,21,87,1,0,4.17,4.73
795,Tamil Nadu,Tamil Nadu Dr. M.G.R. Medical University  Chennai (Id: U0481),AKS GROUP OF INSTITUTIONS (Inst.Code  580) (Id: C49045),Cuddalore,Nursing,0,0,0,0,0,0,1,0,0,3.34
796,Tamil Nadu,Tamil Nadu Dr. M.G.R. Medical University  Chennai (Id: U0481),AN0I TERESA SCHOOL OF NURSINGAND PARAMEDICAL SCIENCES ARIYALUR ARIYALUR (Id: C45800),Ariyalur,Nursing,0,34,34,0,7,7,0,0,4.86,1.62
797,Tamil Nadu,Tamil Nadu Dr. M.G.R. Medical University  Chennai (Id: U0481),AN0I TERESA SCHOOL OF NURSING AND PARAMEDICAL SCIENCES (Inst. Code  362) ARIYALUR (Id: C45800),Ariyalur,Nursing,0,34,34,0,7,7,0,1,4.86,4.96
798,Tamil Nadu,Tamil Nadu Dr. M.G.R. Medical University  Chennai (Id: U0481),ANTHONIAMMAL COMMUNITY COLLEGE  AACC (Inst.Code  517) (Id: C49072),Thanjavur,Nursing,0,0,0,0,0,0,0,0,0,0
799,Tamil Nadu,Tamil Nadu Dr. M.G.R. Medical University  Chennai (Id: U0481),APOLLO MED SKILLS LIMITED (A UNIT OF APOLLO HOSPITALS EDUCATIO0L TRUST) (Inst.Code  597) CHEN0I (Id: C49003),Chennai,Technical/Polytechnic,0,0,0,0,0,0,1,1,0,6.67
800,Tamil Nadu,Tamil Nadu Dr. M.G.R. Medical University  Chennai (Id: U0481),ARAVIND EYE HOSPITAL (Inst. Code  470) THENI (Id: C45719),Theni,Nursing,0,0,0,0,0,0,1,1,0,6.67
801,Tamil Nadu,Tamil Nadu Dr. M.G.R. Medical University  Chennai (Id: U0481),ARAVIND EYE HOSPITAL (Inst. Code  471) TIRUNELVELI (Id: C45679),Tirunelveli,Nursing,0,0,0,0,0,0,1,0,0,3.34
802,Tamil Nadu,Tamil Nadu Dr. M.G.R. Medical University  Chennai (Id: U0481),ARAVIND EYE HOSPITAL (Inst. Code  472)  COIMBATORE (Id: C45568),Coimbatore,Nursing,0,0,0,0,0,0,1,1,0,6.67
803,Tamil Nadu,Tamil Nadu Dr. M.G.R. Medical University  Chennai (Id: U0481),ARCOT SRI MAHALAKSHMI WOMEN S COLLEGE OF NURSING VELLORE  VELLORE (Id: C45666),Vellore,Nursing,0,179,179,0,25,25,1,0,7.16,5.72
804,Tamil Nadu,Tamil Nadu Dr. M.G.R. Medical University  Chennai (Id: U0481),ASIAN INSTITUTE OF MEDICAL ACADEMY (Inst.Code  531) (Id: C49076),Tiruvannamalai,Nursing,0,0,0,0,0,0,0,0,0,0
805,Tamil Nadu,Tamil Nadu Dr. M.G.R. Medical University  Chennai (Id: U0481),BPR INSTITUTE OF HEALTH and MEDICAL SCIENCE Dr. BALAJI HEALTH AND EDUCATION TRUST (Inst. Code  521) VELLORE (Id: C45832),Vellore,Nursing,0,6,6,1,7,8,0,1,0.75,3.59
806,Tamil Nadu,Tamil Nadu Dr. M.G.R. Medical University  Chennai (Id: U0481),CARE INSTITUTE OF BEHAIRORAL SCIENCES (A UNIT OF CARE TRICHY) CHEN0I (Id: C45476),Chennai,Teacher Training,1,12,13,1,2,3,0,0,4.34,1.45
807,Tamil Nadu,Tamil Nadu Dr. M.G.R. Medical University  Chennai (Id: U0481),CARE INSTITUTE OF BEHAIRORAL SCIENCES (A UNIT OF CARE TRICHY) (Inst. Code  389) CHEN0I (Id: C45476),Chennai,Teacher Training,1,12,13,1,2,3,1,0,4.34,4.78
808,Tamil Nadu,Tamil Nadu Dr. M.G.R. Medical University  Chennai (Id: U0481),DEEPAM HOSPITAL LTD. CHEN0I CHEN0I (Id: C45478),Chennai,Nursing,0,8,8,1,2,3,1,0,2.67,4.23
809,Tamil Nadu,Tamil Nadu Dr. M.G.R. Medical University  Chennai (Id: U0481),DEEPAM HOSPITAL LTD. (Inst. Code  397) CHEN0I (Id: C45478),Chennai,Nursing,0,8,8,1,2,3,0,1,2.67,4.23
810,Tamil Nadu,Tamil Nadu Dr. M.G.R. Medical University  Chennai (Id: U0481),Dr. BALAJI HEALTH AND EDUCATION TRUST VELLORE (Id: C45832),Vellore,Nursing,0,6,6,1,7,8,0,1,0.75,3.59
811,Tamil Nadu,Tamil Nadu Dr. M.G.R. Medical University  Chennai (Id: U0481),D.V.C PARA MEDICAL INSTITUTE (Inst. Code  578) CUDDALORE (Id: C49046),Cuddalore,Nursing,0,0,0,0,0,0,0,1,0,3.34
812,Tamil Nadu,Tamil Nadu Dr. M.G.R. Medical University  Chennai (Id: U0481),GANDHIGRAM INSTITUTE OF RURAL HEALTH AND FAMILY WELFARE TRUST DINDIGUL (Id: C45581),Dindigul,Technical/Polytechnic,2,20,22,8,1,9,1,0,2.45,4.15
813,Tamil Nadu,Tamil Nadu Dr. M.G.R. Medical University  Chennai (Id: U0481),GANDHIGRAM INSTITUTE OF RURAL HEALTH AND FAMILY WELFARE TRUST (Inst. Code  040) DINDIGUL (Id: C45581),Dindigul,Nursing,2,20,22,8,1,9,0,0,2.45,0.82
814,Tamil Nadu,Tamil Nadu Dr. M.G.R. Medical University  Chennai (Id: U0481),GEM HOSPITAL and RESEARCH CENTRE PVT. LTD. (Inst. Code  421) COIMBATORE (Id: C45564),Coimbatore,Nursing,0,0,0,0,0,0,1,0,0,3.34
815,Tamil Nadu,Tamil Nadu Dr. M.G.R. Medical University  Chennai (Id: U0481),GOVERNMENT MOHAN KUMARAMANGALAM MEDICAL COLLEGE SALEM SALEM (Id: C45690),Salem,Nursing,254,813,1067,144,89,233,1,1,4.58,8.2
816,Tamil Nadu,Tamil Nadu Dr. M.G.R. Medical University  Chennai (Id: U0481),INDIRA COLLEGE OF NURSING TIRUCHIRAPALLI (Id: C45687),Tiruchirappalli,Nursing,23,156,179,7,0,7,1,0,25.58,11.86
817,Tamil Nadu,Tamil Nadu Dr. M.G.R. Medical University  Chennai (Id: U0481),INDIRA COLLEGE OF NURSING TIRUCHIRAPALLI TIRUCHIRAPALLI (Id: C45687),Tiruchirappalli,Nursing,23,156,179,7,0,7,0,0,25.58,8.53
818,Tamil Nadu,Tamil Nadu Dr. M.G.R. Medical University  Chennai (Id: U0481),JAYAM PARAMEDICAL SCIENCES (MVK NURSING HOME) (Inst. Code  497) THANJAVUR (Id: C45765),Thanjavur,Nursing,0,0,0,0,0,0,1,1,0,6.67
819,Tamil Nadu,Tamil Nadu Dr. M.G.R. Medical University  Chennai (Id: U0481),JP PARAMEDICAL INSTITUTE (Inst. Code  599) CUDDALORE (Id: C49047),Cuddalore,Nursing,0,0,0,0,0,0,1,0,0,3.34
820,Tamil Nadu,Tamil Nadu Dr. M.G.R. Medical University  Chennai (Id: U0481),KARPAGA VI0YAGA INSTITUTE OF MEDICAL SCIENCESAND RESEARCH CENTRE KANCHIPURAM KANCHIPURAM (Id: C45816),Kancheepuram,Nursing,0,0,0,0,0,0,0,1,0,3.34
821,Tamil Nadu,Tamil Nadu Dr. M.G.R. Medical University  Chennai (Id: U0481),KRISH0 HOSPITALAND RESEARCH FOUNDATION CUDDALORE CUDDALORE (Id: C45571),Cuddalore,Technical/Polytechnic,7,7,14,4,0,4,1,1,3.5,7.84
822,Tamil Nadu,Tamil Nadu Dr. M.G.R. Medical University  Chennai (Id: U0481),KRISH0 HOSPITAL AND RESEARCH FOUNDATION (Inst. Code  456) CUDDALORE (Id: C45571),Cuddalore,Nursing,7,7,14,4,0,4,1,1,3.5,7.84
823,Tamil Nadu,Tamil Nadu Dr. M.G.R. Medical University  Chennai (Id: U0481),KUMAR EDUCATIO0L INSTITUTE CUDDALORE CUDDALORE (Id: C45827),Cuddalore,Nursing,0,28,28,0,5,5,0,1,5.6,5.2
824,Tamil Nadu,Tamil Nadu Dr. M.G.R. Medical University  Chennai (Id: U0481),KUMAR EDUCATIO0L INSTITUTE (Inst. Code  510) CUDDALORE (Id: C45827),Cuddalore,Nursing,0,28,28,0,5,5,1,0,5.6,5.2
825,Tamil Nadu,Tamil Nadu Dr. M.G.R. Medical University  Chennai (Id: U0481),MEDISCAN SYSTEMS (Inst. Code  406) CHEN0I (Id: C45481),Chennai,Technical/Polytechnic,0,0,0,0,0,0,0,1,0,3.34
826,Tamil Nadu,Tamil Nadu Dr. M.G.R. Medical University  Chennai (Id: U0481),MEE0KSHI MISSION HOSPITAL AND RESEARCH CENTRE MADURAI (Id: C47555),Madurai,Technical/Polytechnic,8,42,50,4,1,5,0,1,10,6.67
827,Tamil Nadu,Tamil Nadu Dr. M.G.R. Medical University  Chennai (Id: U0481),M.K. EDUCATIO0L INSTITUTE ARIYALUR ARIYALUR (Id: C45407),Ariyalur,Nursing,0,8,8,1,4,5,1,0,1.6,3.87
828,Tamil Nadu,Tamil Nadu Dr. M.G.R. Medical University  Chennai (Id: U0481),M.K. EDUCATIO0L INSTITUTE (Inst. Code  511) ARIYALUR (Id: C45407),Ariyalur,Nursing,0,8,8,1,4,5,1,0,1.6,3.87
829,Tamil Nadu,Tamil Nadu Dr. M.G.R. Medical University  Chennai (Id: U0481),NEHRU COLLEGE OF NURSING (Inst. Code  555) TRICHY (Id: C49088),Tiruchirappalli,Nursing,0,0,0,0,0,0,0,1,0,3.34
830,Tamil Nadu,Tamil Nadu Dr. M.G.R. Medical University  Chennai (Id: U0481),OMAYAL ACHI COLLEGE OF NURSING (Inst. Code  375) CHEN0I (Id: C48991),Chennai,Nursing,0,0,0,0,0,0,1,0,0,3.34
831,Tamil Nadu,Tamil Nadu Dr. M.G.R. Medical University  Chennai (Id: U0481),RABINRA0TH TAGORE COLLEGE OF NURSING FOR WOMEN SALEM SALEM (Id: C45698),Salem,Nursing,0,55,55,0,12,12,0,1,4.59,4.87
832,Tamil Nadu,Tamil Nadu Dr. M.G.R. Medical University  Chennai (Id: U0481),REGIO0L INSTITUTE OF OPHTHALMOLOGY AND GOVT. OPHTHALMIC HOSPITAL (MMC) EGMORE (Inst. Code  416) CHEN0I (Id: C49018),Chennai,Technical/Polytechnic,0,0,0,0,0,0,1,1,0,6.67
833,Tamil Nadu,Tamil Nadu Dr. M.G.R. Medical University  Chennai (Id: U0481),RIGHT HOSPITALS CHEN0I CHEN0I (Id: C45508),Chennai,Technical/Polytechnic,1,2,3,8,1,9,1,1,0.34,6.78
834,Tamil Nadu,Tamil Nadu Dr. M.G.R. Medical University  Chennai (Id: U0481),SAKTHI NURSING SCHOOL CHEN0I (Id: C45505),Chennai,Nursing,0,5,5,0,4,4,1,0,1.25,3.75
835,Tamil Nadu,Tamil Nadu Dr. M.G.R. Medical University  Chennai (Id: U0481),SAKTHI NURSING SCHOOL CHEN0I CHEN0I (Id: C45505),Chennai,Nursing,0,5,5,0,4,4,1,0,1.25,3.75
836,Tamil Nadu,Tamil Nadu Dr. M.G.R. Medical University  Chennai (Id: U0481),SAKTHI NURSING SCHOOL (Inst. Code  480) CHEN0I (Id: C45505),Chennai,Nursing,0,5,5,0,4,4,1,0,1.25,3.75
837,Tamil Nadu,Tamil Nadu Dr. M.G.R. Medical University  Chennai (Id: U0481),SHAKTHI COLLEGE OF PARAMEDICAL SCIENCE THANJAVUR (Id: C45818),Thanjavur,Nursing,0,9,9,0,4,4,0,1,2.25,4.09
838,Tamil Nadu,Tamil Nadu Dr. M.G.R. Medical University  Chennai (Id: U0481),SHERIL MARTH PARAMEDICAL INSTITUTION THANJAVUR THANJAVUR (Id: C45759),Thanjavur,Nursing,0,30,30,1,5,6,1,0,5,5
839,Tamil Nadu,Tamil Nadu Dr. M.G.R. Medical University  Chennai (Id: U0481),SHERLI MARIN PARAMEDICAL INSTITUTION (Inst. Code  516) THANJAVUR (Id: C45759),Thanjavur,Nursing,0,30,30,1,5,6,1,1,5,8.34
840,Tamil Nadu,Tamil Nadu Dr. M.G.R. Medical University  Chennai (Id: U0481),SHREE SIVAA HOSPITAL PVT. LTD. COIMBATORE COIMBATORE (Id: C45560),Coimbatore,Nursing,6,0,6,0,0,0,1,1,0,6.67
841,Tamil Nadu,Tamil Nadu Dr. M.G.R. Medical University  Chennai (Id: U0481),SHREE SIVAA HOSPITAL PVT. LTD. (Inst. Code  390) COIMBATORE (Id: C45560),Coimbatore,Nursing,6,0,6,0,0,0,0,0,0,0
842,Tamil Nadu,Tamil Nadu Dr. M.G.R. Medical University  Chennai (Id: U0481),SREE ABIRAMI HOSPITAL (P) LTD. COIMBATORE COIMBATORE (Id: C45558),Coimbatore,Nursing,0,5,5,7,0,7,0,1,0.72,3.58
843,Tamil Nadu,Tamil Nadu Dr. M.G.R. Medical University  Chennai (Id: U0481),SREE ABIRAMI HOSPITAL (P) LTD. (Inst. Code  387) COIMBATORE (Id: C45558),Coimbatore,Nursing,0,5,5,7,0,7,1,0,0.72,3.58
844,Tamil Nadu,Tamil Nadu Dr. M.G.R. Medical University  Chennai (Id: U0481),SRI AN0MALAIYAR COLLEGE OF PARAMEDICAL SCIENCES (Inst. Code  559) DHARMAPURI (Id: C49048),Dharmapuri,Nursing,0,0,0,0,0,0,0,1,0,3.34
845,Tamil Nadu,Tamil Nadu Dr. M.G.R. Medical University  Chennai (Id: U0481),SRILAKSHMI HAIGIRIVASH EDUCATIO0L TRUST (Inst. Code  435) VILLUPURAM (Id: C45732),Viluppuram,Nursing,0,38,38,0,8,8,0,0,4.75,1.59
846,Tamil Nadu,Tamil Nadu Dr. M.G.R. Medical University  Chennai (Id: U0481),SRILAKSHMI HAIGIRIVASH EDUCATIO0L TRUST VILLUPURAM VILLUPURAM (Id: C45732),Viluppuram,Nursing,0,38,38,0,8,8,0,0,4.75,1.59
847,Tamil Nadu,Tamil Nadu Dr. M.G.R. Medical University  Chennai (Id: U0481),SRI MOOKAMBIKA COLLEGE OF NURSING KANYAKUMARI  KANYAKUMARI (Id: C45617),Kanniyakumari,Nursing,0,75,75,0,68,68,0,0,1.11,0.37
848,Tamil Nadu,Tamil Nadu Dr. M.G.R. Medical University  Chennai (Id: U0481),SRI SAKTHI 0RAYANI SCHOOL OF NURSING and PARAMEDICAL SCIENCES (Inst. Code  577) VELLORE (Id: C49099),Vellore,Teacher Training,0,0,0,0,0,0,1,1,0,6.67
849,Tamil Nadu,Tamil Nadu Dr. M.G.R. Medical University  Chennai (Id: U0481),SRI VIRUDHAMBIGAI PARAMEDICAL COLLEGE CUDDALORE CUDDALORE (Id: C45794),Cuddalore,Nursing,0,28,28,0,7,7,0,1,4,4.67
850,Tamil Nadu,Tamil Nadu Dr. M.G.R. Medical University  Chennai (Id: U0481),SRI VIRUDHAMBIGAI PARAMEDICAL COLLEGE (Inst. Code  474) CUDDALORE (Id: C45794),Cuddalore,Nursing,0,28,28,0,7,7,0,1,4,4.67
851,Tamil Nadu,Tamil Nadu Dr. M.G.R. Medical University  Chennai (Id: U0481),St. ISABELS COLLEGE OF NURSING CHEN0I (Id: C47566),Chennai,Nursing,0,174,174,0,23,23,0,0,7.57,2.53
852,Tamil Nadu,Tamil Nadu Dr. M.G.R. Medical University  Chennai (Id: U0481),ST.JOHN'S PARAMEDICAL COLLEGE (Inst. Code  520) PUDUKKOTTAI (Id: C45828),Pudukkottai,Nursing,0,10,10,0,4,4,0,1,2.5,4.17
853,Tamil Nadu,Tamil Nadu Dr. M.G.R. Medical University  Chennai (Id: U0481),ST.JOHN S PARAMEDICAL COLLEGE PUDUKKOTTAI (Id: C45828),Pudukkottai,Nursing,0,10,10,0,4,4,0,1,2.5,4.17
854,Tamil Nadu,Tamil Nadu Dr. M.G.R. Medical University  Chennai (Id: U0481),ST. JOSEPH'S PARAMEDICAL COLLEGE (Inst. Code  485) KRISH0GIRI (Id: C45635),Krishnagiri,Nursing,1,7,8,1,6,7,1,1,1.15,7.05
855,Tamil Nadu,Tamil Nadu Dr. M.G.R. Medical University  Chennai (Id: U0481),ST. JOSEPH S PARAMEDICAL COLLEGE KRISH0GIRI KRISH0GIRI (Id: C45635),Krishnagiri,Nursing,1,7,8,1,6,7,0,0,1.15,0.39
856,Tamil Nadu,Tamil Nadu Dr. M.G.R. Medical University  Chennai (Id: U0481),ST.MARY'S COLLEGE OF PARAMEDICAL SCIENCE (Inst. Code  505) CUDDALORE (Id: C45572),Cuddalore,Nursing,0,40,40,0,7,7,1,1,5.72,8.58
857,Tamil Nadu,Tamil Nadu Dr. M.G.R. Medical University  Chennai (Id: U0481),ST.MARYS COLLEGE OF PARAMEDICAL SCIENCES CUDDALORE CUDDALORE (Id: C45572),Cuddalore,Nursing,0,40,40,0,7,7,1,1,5.72,8.58
858,Tamil Nadu,Tamil Nadu Dr. M.G.R. Medical University  Chennai (Id: U0481),ST.PAUL'S COMMUNITY COLLEGE (Inst. Code  567) TRICHY (Id: C49089),Tiruchirappalli,Nursing,0,0,0,0,0,0,0,0,0,0
859,Tamil Nadu,Tamil Nadu Dr. M.G.R. Medical University  Chennai (Id: U0481),SUGAM HOSPITALS (P) LTD. (Inst. Code  369) CHEN0I (Id: C45470),Chennai,Nursing,0,0,0,0,0,0,0,1,0,3.34
860,Tamil Nadu,Tamil Nadu Dr. M.G.R. Medical University  Chennai (Id: U0481),SURABI COLLEGE OF NURSING COIMBATORE (Id: C45569),Coimbatore,Nursing,0,20,20,0,0,0,1,0,0,3.34
861,Tamil Nadu,Tamil Nadu Dr. M.G.R. Medical University  Chennai (Id: U0481),SURABI COLLEGE OF NURSING COIMBATORE COIMBATORE (Id: C45569),Coimbatore,Nursing,0,20,20,0,0,0,1,0,0,3.34
862,Tamil Nadu,Tamil Nadu Dr. M.G.R. Medical University  Chennai (Id: U0481),SURABI COLLEGE OF NURSING (Inst. Code  502) COIMBATORE (Id: C45569),Coimbatore,Nursing,0,20,20,0,0,0,0,0,0,0
863,Tamil Nadu,Tamil Nadu Dr. M.G.R. Medical University  Chennai (Id: U0481),SURABI SCHOOL OF NURSING DINDIGUL DINDIGUL (Id: C45583),Dharmapuri,Nursing,0,0,0,0,0,0,1,1,0,6.67
864,Tamil Nadu,Tamil Nadu Dr. M.G.R. Medical University  Chennai (Id: U0481),SURABI SCHOOL OF NURSING KARUR (Id: C45632),Karur,Nursing,0,30,30,0,6,6,0,0,5,1.67
865,Tamil Nadu,Tamil Nadu Dr. M.G.R. Medical University  Chennai (Id: U0481),SURABI SCHOOL OF NURSING KARUR KARUR (Id: C45632),Karur,Nursing,0,30,30,0,6,6,0,1,5,5
866,Tamil Nadu,Tamil Nadu Dr. M.G.R. Medical University  Chennai (Id: U0481),TAMIL 0DU INSTITUTE OF PALLIATIVE MEDICINE and PARA MEDICAL SCIENCE OF SCOPE INDIA (Inst. Code  560) CUDDALORE (Id: C49044),Cuddalore,Nursing,0,0,0,0,0,0,1,0,0,3.34
867,Tamil Nadu,Tamil Nadu Dr. M.G.R. Medical University  Chennai (Id: U0481),TARA INSTITUTE OF PARA MEDICAL SCIENCES (Inst. Code  458) VILLUPURAM (Id: C45736),Viluppuram,Nursing,0,37,37,0,6,6,0,0,6.17,2.06
868,Tamil Nadu,Tamil Nadu Dr. M.G.R. Medical University  Chennai (Id: U0481),TARA INSTITUTE OF PARA MEDICAL SCIENCES VILUPURAM VILUPURAM (Id: C45736),Viluppuram,Nursing,0,37,37,0,6,6,1,0,6.17,5.39
869,Tamil Nadu,Tamil Nadu Dr. M.G.R. Medical University  Chennai (Id: U0481),TCR HOSPITAL and CHARITABLE TRUST (Inst. Code  558) KRISH0GIRI (Id: C49059),Krishnagiri,Nursing,0,0,0,0,0,0,0,0,0,0
870,Tamil Nadu,Tamil Nadu Dr. M.G.R. Medical University  Chennai (Id: U0481),TEAM SPECIALITY HOSPITAL (Inst. Code  452) PUDUKKOTTAI (Id: C45707),Pudukkottai,Nursing,0,22,22,6,18,24,0,0,0.92,0.31
871,Tamil Nadu,Tamil Nadu Dr. M.G.R. Medical University  Chennai (Id: U0481),TEAM SPECIALITY HOSPITAL PUDUKKOTTAI PUDUKKOTTAI (Id: C45707),Pudukkottai,Nursing,0,22,22,6,18,24,1,0,0.92,3.64
872,Tamil Nadu,Tamil Nadu Dr. M.G.R. Medical University  Chennai (Id: U0481),THIRUVALLUVAR NURSING INSTITUTION (Inst. Code  600) VILLUPURAM (Id: C49103),Viluppuram,Nursing,0,0,0,0,0,0,0,1,0,3.34
873,Tamil Nadu,Tamil Nadu Dr. M.G.R. Medical University  Chennai (Id: U0481),VAIGARAI NURSING and HEALTH SCIENCE COLLEGE (Inst. Code  557) THIRUVAIYARU (Id: C49073),Thanjavur,Nursing,0,0,0,0,0,0,0,0,0,0
874,Tamil Nadu,Tamil Nadu Dr. M.G.R. Medical University  Chennai (Id: U0481),VEECARE COLLEGE OF HEALTH SCIENCE (Inst. Code  476) CHEN0I (Id: C48995),Chennai,Technical/Polytechnic,0,0,0,0,0,0,1,0,0,3.34
875,Tamil Nadu,Tamil Nadu Dr. M.G.R. Medical University  Chennai (Id: U0481),VELLORE INSTITUTE OF PARA MEDICALS (Inst. Code  518) VELLORE (Id: C49098),Vellore,Nursing,0,0,0,0,0,0,1,0,0,3.34
876,Tamil Nadu,Tamil Nadu Dr. M.G.R. Medical University  Chennai (Id: U0481),VENKATESWARA COLLEGE OF PHARMACY and NURSING A0IKKARI ( Inst. Code  563) (Id: C49074),Thanjavur,Nursing,0,0,0,0,0,0,0,0,0,0
877,Tamil Nadu,Tamil Nadu Dr. M.G.R. Medical University  Chennai (Id: U0481),VENKATESWARA COLLEGE OF PHARMACY and NURSING (Inst. Code  539) KUMBAKKO0M (Id: C49077),Thanjavur,Nursing,0,0,0,0,0,0,0,0,0,0
878,Tamil Nadu,Tamil Nadu Dr. M.G.R. Medical University  Chennai (Id: U0481),VENKATESWARA COLLEGE OF PHARMACY and NURSING MAN0RGUDI ( Inst. Code  540) (Id: C49075),Thiruvarur,Nursing,0,0,0,0,0,0,0,0,0,0
879,Tamil Nadu,Tamil Nadu Dr. M.G.R. Medical University  Chennai (Id: U0481),VI0YAGA NURSING COLLEGE (529) (Id: C48984),Ariyalur,Nursing,0,0,0,0,0,0,1,1,0,6.67
880,Tamil Nadu,Tamil Nadu Dr. M.G.R. Medical University  Chennai (Id: U0481),VI0YAGA NURSING COLLEGE (Inst. Code 529) Ariyalur (Id: C48984),Ariyalur,Nursing,0,0,0,0,0,0,1,0,0,3.34
881,Tamil Nadu,Tamil Nadu Dr. M.G.R. Medical University  Chennai (Id: U0481),VIVEKA0NDA (RABINRA0TH TAGORE) NURSING COLLEGE FOR WOMEN (Inst. Code  235) SALEM (Id: C45698),Salem,Nursing,0,55,55,0,12,12,1,1,4.59,8.2
882,Tamil Nadu,Tamil Nadu Teacher Education University Chennai (Id: U0483),Aravindhar College of Education (Id: C14938),Tiruvannamalai,Teacher Training,48,52,100,5,2,7,0,1,14.29,8.1
883,Tamil Nadu,Tamil Nadu Teacher Education University Chennai (Id: U0483),A.S. College of Education (Id: C14922),Madurai,Teacher Training,0,0,0,0,0,0,0,0,0,0
884,Tamil Nadu,Tamil Nadu Teacher Education University Chennai (Id: U0483),Bharat College of Education (Id: C14634),Vellore,Teacher Training,23,45,68,7,8,15,1,1,4.54,8.18
885,Tamil Nadu,Tamil Nadu Teacher Education University Chennai (Id: U0483),Bharathi Vidyalaya College of Education (Id: C14608),Pudukkottai,Teacher Training,0,0,0,0,0,0,1,0,0,3.34
886,Tamil Nadu,Tamil Nadu Teacher Education University Chennai (Id: U0483),Bhavani College of Education (Id: C14720),Cuddalore,Teacher Training,0,0,0,0,0,0,1,1,0,6.67
887,Tamil Nadu,Tamil Nadu Teacher Education University Chennai (Id: U0483),Bishop Packiam Arokiaswamy College of Education (Id: C14681),Pudukkottai,Teacher Training,0,0,0,0,0,0,0,1,0,3.34
888,Tamil Nadu,Tamil Nadu Teacher Education University Chennai (Id: U0483),E.S. College of Education (Id: C14978),Viluppuram,Teacher Training,0,0,0,0,0,0,0,1,0,3.34
889,Tamil Nadu,Tamil Nadu Teacher Education University Chennai (Id: U0483),Government College of Education (Id: C14598),Thanjavur,Teacher Training,0,0,0,0,0,0,0,1,0,3.34
890,Tamil Nadu,Tamil Nadu Teacher Education University Chennai (Id: U0483),Jairupa College of Education (Id: C14418),Erode,Teacher Training,38,97,135,11,6,17,1,1,7.95,9.32
891,Tamil Nadu,Tamil Nadu Teacher Education University Chennai (Id: U0483),Muslim College of Education (Id: C14781),Kanniyakumari,Teacher Training,23,102,125,6,7,13,1,1,9.62,9.88
892,Tamil Nadu,Tamil Nadu Teacher Education University Chennai (Id: U0483),Nairs College of Education (Id: C15018),Coimbatore,Teacher Training,14,86,100,7,2,9,1,0,11.12,7.04
893,Tamil Nadu,Tamil Nadu Teacher Education University Chennai (Id: U0483),N.K.T.National College of Education for Women (Autonomous) (Id: C14872),Chennai,Teacher Training,0,274,274,0,25,25,1,1,10.96,10.32
894,Tamil Nadu,Tamil Nadu Teacher Education University Chennai (Id: U0483),Rajas College of Education (Id: C14533),Tirunelveli,Teacher Training,10,79,89,3,6,9,0,1,9.89,6.63
895,Tamil Nadu,Tamil Nadu Teacher Education University Chennai (Id: U0483),R.K. Samy College of Education (Id: C14866),Ramanathapuram,Teacher Training,4,96,100,5,3,8,0,0,12.5,4.17
896,Tamil Nadu,Tamil Nadu Teacher Education University Chennai (Id: U0483),S.M.R. College of Education (Id: C15027),Pudukkottai,Teacher Training,20,80,100,6,4,10,1,0,10,6.67
897,Tamil Nadu,Tamil Nadu Teacher Education University Chennai (Id: U0483),Sri Rengeswarer College of Education (Id: C14469),Namakkal,Teacher Training,19,29,48,1,6,7,0,0,6.86,2.29
898,Tamil Nadu,Tamil Nadu Teacher Education University Chennai (Id: U0483),Sri Vidya College of Education (Id: C14816),Virudhunagar,Teacher Training,7,75,82,6,2,8,1,0,10.25,6.75
899,Tamil Nadu,Tamil Nadu Teacher Education University Chennai (Id: U0483),St.Marys College of Education and Research Institute (Id: C14775),Kancheepuram,Teacher Training,0,99,99,0,8,8,1,1,12.38,10.8
900,Tamil Nadu,Tamil Nadu Teacher Education University Chennai (Id: U0483),TVS Teacher Training Academy (Id: C14887),Madurai,Teacher Training,8,91,99,1,7,8,1,1,12.38,10.8
901,Telangana,Jawaharlal Nehru Technological University Hyderabad (Id: U0017),Anu Bose Institute of Technology (Id: C19776),Khammam,Technical/Polytechnic,531,391,922,59,53,112,0,0,8.24,2.75
902,Telangana,Jawaharlal Nehru Technological University Hyderabad (Id: U0017),Daripally Anantharamulu College of Engineering and Technology (Id: C19595),Khammam,Technical/Polytechnic,0,0,0,0,0,0,0,0,0,0
903,Telangana,Jawaharlal Nehru Technological University Hyderabad (Id: U0017),Sree Rama Institute of Science and Technology (Id: C19851),Khammam,Technical/Polytechnic,0,0,0,0,0,0,0,0,0,0
904,Telangana,Jawaharlal Nehru Technological University Hyderabad (Id: U0017),Sri Kavita Engineering College (Id: C19640),Khammam,Technical/Polytechnic,1098,677,1775,122,54,176,0,1,10.09,6.7
905,Telangana,Kakatiya University Warangal (Id: U0019),Anniebesant College of Education Kranthi Nagar Ballepally Khammam (Id: C27264),Khammam,Teacher Training,57,63,120,6,4,10,0,1,12,7.34
906,Telangana,Kakatiya University Warangal (Id: U0019),Dr. M.R. Reddy College of Education Parkal (Id: C27407),Warangal,Teacher Training,45,75,120,9,1,10,1,1,12,10.67
907,Telangana,Kakatiya University Warangal (Id: U0019),Dr. Rajendra Prasad B.Ed. College Asifabad (Id: C27438),Adilabad,Teacher Training,42,58,100,8,0,8,1,1,12.5,10.84
908,Telangana,Kakatiya University Warangal (Id: U0019),Rahman s College of Education Jangaon (Id: C27345),Warangal,Teacher Training,13,87,100,7,1,8,1,1,12.5,10.84
909,Telangana,Kakatiya University Warangal (Id: U0019),St. Mary's Colelge of EducationJangaon (Id: C40802),Warangal,Teacher Training,0,0,0,0,0,0,1,1,0,6.67
910,Telangana,Kakatiya University Warangal (Id: U0019),Vivekananda College of Education Adilabad (Id: C27324),Adilabad,Teacher Training,0,0,0,0,0,0,0,0,0,0
911,Telangana,Mahatma Gandhi University Nalgonda (Id: U0022),KHATIZA KUTHUN COLLEGE OF EDUCAITON NIDMANOOR (Id: C33257),Nalgonda,Teacher Training,0,0,0,13,0,13,1,0,0,3.34
912,Telangana,Maulana Azad National Urdu University Hyderabad (Id: U0023),MANUU POLYTECHNIC RANGAREDDY (Id: C46610),Rangareddy,Technical/Polytechnic,359,13,372,16,8,24,0,0,15.5,5.17
913,Telangana,Osmania University Hyderabad (Id: U0027),G.V.K. Emergency Management and Research Institute (Id: C25426),Hyderabad,Technical/Polytechnic,0,0,0,0,0,0,0,0,0,0
914,Telangana,Osmania University Hyderabad (Id: U0027),Pragna College of Education (Id: C25675),Rangareddy,Teacher Training,32,34,66,10,1,11,1,0,6,5.34
915,Telangana,Osmania University Hyderabad (Id: U0027),Presidency College of Education for Girls (Id: C25472),Hyderabad,Teacher Training,0,100,100,3,6,9,0,1,11.12,7.04
916,Telangana,Osmania University Hyderabad (Id: U0027),RBVRR College for Women (Id: C26006),Hyderabad,Technical/Polytechnic,0,2188,2188,0,79,79,1,0,27.7,12.57
917,Telangana,Osmania University Hyderabad (Id: U0027),Shree Shakthi College of Hotel Management (Id: C25433),Hyderabad,Technical/Polytechnic,106,4,110,9,5,14,1,1,7.86,9.29
918,Telangana,Osmania University Hyderabad (Id: U0027),Sri Venkateshwara College of Education (Id: C25669),Rangareddy,Teacher Training,55,42,97,7,1,8,0,1,12.13,7.38
919,Telangana,Osmania University Hyderabad (Id: U0027),St. Judes College of Education (Id: C25792),Rangareddy,Teacher Training,0,92,92,5,1,6,1,1,15.34,11.78
920,Telangana,Palamuru University Mahabubnagar (Id: U0028),Noor College of Education Shadnagar (Id: C21980),Mahbubnagar,Teacher Training,11,38,49,7,2,9,1,0,5.45,5.15
921,Telangana,Palamuru University Mahabubnagar (Id: U0028),Scholors College of Education Wanaparthy (Id: C22017),Mahbubnagar,Teacher Training,50,50,100,7,1,8,1,1,12.5,10.84
922,Telangana,Telangana University Nizamabad (Id: U0040),Indur College of Education Bodhan (5281) (Id: C35074),Nizamabad,Teacher Training,43,77,120,7,1,8,0,1,15,8.34
923,Tripura,Tripura University Agartala (Id: U0495),Dhalai District Polytechnic Institute (Id: C9586),Dhalai,Technical/Polytechnic,244,97,341,3,0,3,0,1,113.67,41.23
924,Tripura,Tripura University Agartala (Id: U0495),Regional College of Physical Education (Id: C9596),North Tripura,Teacher Training,0,0,0,0,0,0,0,0,0,0
925,Tripura,Tripura University Agartala (Id: U0495),TRIPURA STATE ACADEMY OF TRIBAL CULTURE AGARTALA (Id: C47427),West Tripura,Technical/Polytechnic,0,0,0,0,0,0,1,1,0,6.67
926,Tripura,Tripura University Agartala (Id: U0495),Women's Polytechnic College (Id: C9593),West Tripura,Technical/Polytechnic,0,352,352,16,12,28,0,1,12.58,7.53
927,Uttar Pradesh,Chatrapati Sahuji Maharaj Kanpur University Kanpur (Id: U0505),MAYANK SHEKHAR MAHAVIDYALAYA KAURAWAN (Id: C12206),Kanpur Dehat,Technical/Polytechnic,9,429,438,16,4,20,0,0,21.9,7.3
928,Uttar Pradesh,Chatrapati Sahuji Maharaj Kanpur University Kanpur (Id: U0505),0RAYAN ARYA KANYA PATHSHALA (Id: C12147),Farrukhabad,Technical/Polytechnic,0,0,0,0,0,0,0,1,0,3.34
929,Uttar Pradesh,Chatrapati Sahuji Maharaj Kanpur University Kanpur (Id: U0505),PREMA KATIYAR SIKSHAN SANSTHAN MAHAVIDYALAYA (Id: C12054),Kanpur Dehat,Teacher Training,897,629,1526,21,10,31,0,1,49.23,19.75
930,Uttar Pradesh,Chatrapati Sahuji Maharaj Kanpur University Kanpur (Id: U0505),RAM JANKI MAHAVIDYALAYA ASAI BAIRY SAWAI (Id: C12162),Kanpur Dehat,Teacher Training,1087,939,2026,15,5,20,1,1,101.3,40.44
931,Uttar Pradesh,Chatrapati Sahuji Maharaj Kanpur University Kanpur (Id: U0505),REGIO0L INSTITUTE OF OPHTHALMOLOGY (Id: C12387),Sitapur,Nursing,50,20,70,7,3,10,1,1,7,9
932,Uttar Pradesh,Chatrapati Sahuji Maharaj Kanpur University Kanpur (Id: U0505),SHIVAJI VIDYAPEETH MAHAVIDYALAYA LAHARPUR (Id: C12441),Sitapur,Technical/Polytechnic,2940,1220,4160,18,11,29,1,0,143.45,51.15
933,Uttar Pradesh,Chatrapati Sahuji Maharaj Kanpur University Kanpur (Id: U0505),SHRI KRISH0 MAHAVIDYALAYA 0GLA HARJU (Id: C12322),Etawah,Teacher Training,424,182,606,8,3,11,0,1,55.1,21.7
934,Uttar Pradesh,Chatrapati Sahuji Maharaj Kanpur University Kanpur (Id: U0505),SRI SURAJ DATT KANTI DEVI MAHILA MAHAVIDHYALAYA KHIRO (Id: C50167),Rae Bareli,Teacher Training,0,0,0,0,0,0,0,0,0,0
935,Uttar Pradesh,Choudhary Charan Singh University Meerut (Id: U0506),INSTITUTE OF TEACHER EDUCATION DELHIMEERUT ROAD KADARBAD MODI0GAR (GHAZIABAD) (Id: C28762),Ghaziabad,Teacher Training,0,0,0,0,0,0,1,1,0,6.67
936,Uttar Pradesh,Dr. B. R. Ambedkar University Agra (Id: U0509),KRISH0 COLLEGE OF SPORTS and EDUCATION BAMRAULI KATARA AGRA (Id: C15370),Agra,Teacher Training,47,53,100,3,5,8,0,0,12.5,4.17
937,Uttar Pradesh,Gautam Buddh Technical University Lucknow (Id: U0549),DR K N MODI GIRLS ENGINEERING COLLEGE MODI0GAR (Id: C46986),Ghaziabad,Technical/Polytechnic,24,95,119,34,28,62,0,1,1.92,3.98
938,Uttar Pradesh,Integral University Lucknow (Id: U0519),University Polytechnic Shahjahanpur (Id: C1073),Shahjahanpur,Technical/Polytechnic,324,0,324,21,0,21,1,0,15.43,8.48
939,Uttar Pradesh,KING GEORGE MEDICAL UNIVERSITY (Id: U0523),B.C.M College of Nursing (Id: C31902),Sitapur,Nursing,0,208,208,0,22,22,0,0,9.46,3.16
940,Uttar Pradesh,Mahamaya Technical University (Id: U0526),KISHAN INSTITUTE OF ENGINEERING AND TECHNOLOGY MEERUT (Id: C46418),Meerut,Technical/Polytechnic,515,73,588,62,44,106,0,0,5.55,1.85
941,Uttar Pradesh,Mahatama Jyotiba Phule Rohikhand University Bareilly (Id: U0525),Jagdesh Saran Hindu (PG) College Amroha (Id: C13485),Jyotiba Phule Nagar,Technical/Polytechnic,3611,4828,8439,37,24,61,0,1,138.35,49.45
942,Uttar Pradesh,Mahatama Jyotiba Phule Rohikhand University Bareilly (Id: U0525),Kothiwal Dental College and Research Centre (Id: C13457),Moradabad,Teacher Training,0,0,0,0,0,0,1,1,0,6.67
943,Uttar Pradesh,Sampurnanand Sanskrit Vishwavidyalaya Varanasi (Id: U0537),Parashuram Seva Sansthan Gyanchandra Sanskrit Mahavidyalaya Rampur Mahval (Id: C20531),Ballia,Teacher Training,45,109,154,7,0,7,0,0,22,7.34
944,Uttar Pradesh,Veer Bahadur Singh Purvanchal University Jaunpur (Id: U0550),Abdul Aziz Ansari Degree College Majadiha Shahganj  Jaunpur (Id: C16138),Jaunpur,Teacher Training,209,499,708,23,2,25,1,0,28.32,12.78
945,Uttar Pradesh,Veer Bahadur Singh Purvanchal University Jaunpur (Id: U0550),Parwati Mahila Degree College Doharighat Mau (Id: C15981),Mau,Teacher Training,0,0,0,0,0,0,0,1,0,3.34
946,Uttrakhand,Hemwati Nandan Bahuguna Garhwal Univeristy Srinagar Garhwal (Id: U0557),Dayanand Womens Training College Dehradun (Id: C24589),Dehradun,Teacher Training,0,70,70,0,8,8,0,1,8.75,6.25
947,Uttrakhand,Uttrakhand Technical University Dehradun (Id: U0566),B.F.I.T. Technical Campus (Id: C21293),Dehradun,Technical/Polytechnic,178,77,255,53,31,84,0,1,3.04,4.35
948,Uttrakhand,Uttrakhand Technical University Dehradun (Id: U0566),Roorkee College of Pharmacy (Id: C21272),Hardwar,Technical/Polytechnic,119,42,161,10,9,19,1,1,8.48,9.5
949,West Bengal,Burdwan University Burdwan (Id: U0569),Athena B. Ed. College (Id: C44780),Bankura,Teacher Training,51,49,100,7,1,8,0,0,12.5,4.17
950,West Bengal,Burdwan University Burdwan (Id: U0569),Bijoy Pal Memorial B. Ed. College (Id: C44746),Barddhaman,Teacher Training,36,61,97,7,2,9,1,0,10.78,6.93
951,West Bengal,Burdwan University Burdwan (Id: U0569),Deben Mahato Teachers' Training College (Id: C44749),Puruliya,Teacher Training,39,56,95,11,4,15,1,0,6.34,5.45
952,West Bengal,Burdwan University Burdwan (Id: U0569),Mohanananda College (Id: C44758),Barddhaman,Teacher Training,31,69,100,4,4,8,1,0,12.5,7.5
953,West Bengal,Burdwan University Burdwan (Id: U0569),SwarajnagarTeachers' Training College (B. Ed.) (Id: C44698),Bankura,Teacher Training,48,49,97,9,1,10,0,0,9.7,3.24
954,West Bengal,Burdwan University Burdwan (Id: U0569),Tarapith College of B.Ed. (Id: C44666),Birbhum,Teacher Training,0,0,0,0,0,0,1,0,0,3.34
955,West Bengal,Calcutta University Kolkata (Id: U0570),Gangadharpur Sikshan Mandir (Id: C11870),Haora,Teacher Training,64,86,150,10,9,19,1,0,7.9,5.97
956,West Bengal,Kalyani University Kalyani (Id: U0576),Central Cerucltural Research and Training Institute (Id: C44043),Murshidabad,Technical/Polytechnic,16,10,26,30,6,36,1,0,0.73,3.58
957,West Bengal,Kalyani University Kalyani (Id: U0576),J.R.S.E.T. College of Education (Id: C7052),Nadia,Teacher Training,30,65,95,6,8,14,0,1,6.79,5.6
958,West Bengal,Kalyani University Kalyani (Id: U0576),Monarch College of Art and Technology (Id: C7111),Murshidabad,Technical/Polytechnic,18,1,19,5,1,6,1,0,3.17,4.39
959,West Bengal,Kalyani University Kalyani (Id: U0576),Renuka Debi B.Ed. College (Id: C7118),Nadia,Teacher Training,53,47,100,11,1,12,1,0,8.34,6.12
960,West Bengal,Kalyani University Kalyani (Id: U0576),Tagore School of Rural Development and Agriculture (Id: C7087),Nadia,Technical/Polytechnic,0,0,0,0,0,0,1,1,0,6.67
961,West Bengal,North Bengal University Darjeeling (Id: U0579),GOVT. COLLEGE OF PHYSICAL EDUCATION FOR WOMEN COOCHBEHAR (Id: C45327),Koch Bihar,Teacher Training,0,50,50,1,2,3,0,1,16.67,8.89
962,West Bengal,North Bengal University Darjeeling (Id: U0579),VIDYASAGAR COLLEGE OF EDUCATION DARJILING (Id: C45783),Darjiling,Teacher Training,43,57,100,4,5,9,1,0,11.12,7.04
963,West Bengal,SidhoKanho Birsa University (Id: U0583),Deben Mahato Teachers' Training College (Id: C44749),Puruliya,Teacher Training,39,56,95,11,4,15,1,0,6.34,5.45
964,West Bengal,SidhoKanho Birsa University (Id: U0583),HALADHAR MAHATO TEACHERS TRAINING INSTITUTE (Id: C50002),Puruliya,Teacher Training,52,12,64,7,6,13,1,0,4.93,4.98
965,West Bengal,The West Bengal University of Health Sciences Kolkata (Id: U0586),College of Medicine and J N M Hospital Kalyani (Id: C16382),Nadia,Nursing,249,148,397,100,29,129,0,0,3.08,1.03
966,West Bengal,University of Gour Banga Malda (Id: U0571),CHANCHAL B ED COLLEGE MALDA (Id: C46603),Maldah,Teacher Training,62,38,100,7,2,9,1,0,11.12,7.04
967,West Bengal,University of Gour Banga Malda (Id: U0571),DAVID HARE TEACHERS TRAINING COLLEGE MALDA (Id: C46604),Maldah,Teacher Training,62,38,100,8,2,10,1,0,10,6.67
968,West Bengal,University of Gour Banga Malda (Id: U0571),DR SARVAPALLI RADHAKRISH0N B ED COLLEGE MALDA (Id: C46605),Maldah,Teacher Training,54,45,99,9,2,11,0,0,9,3
969,West Bengal,University of Gour Banga Malda (Id: U0571),KALIACHAK SULTA0 COLLEGE OF EDUCATION MALDA (Id: C46653),Maldah,Teacher Training,70,30,100,8,2,10,1,0,10,6.67
970,West Bengal,University of Gour Banga Malda (Id: U0571),Moulana Abul Kalam Azad B. Ed. College (Id: C42692),Uttar Dinajpur,Teacher Training,57,43,100,5,5,10,0,0,10,3.34
971,West Bengal,University of Gour Banga Malda (Id: U0571),NETAJI SUBHAS CHANDRA BOSE TEACHERS TRAINING COLLGE UTTAR DIJ0PUR (Id: C46607),Uttar Dinajpur,Teacher Training,53,47,100,8,3,11,0,0,9.1,3.04
972,West Bengal,University of Gour Banga Malda (Id: U0571),North Malda Teachears' Education College (Id: C42693),Maldah,Teacher Training,73,27,100,6,2,8,1,1,12.5,10.84
973,West Bengal,University of Gour Banga Malda (Id: U0571),PAKUAHAT TEACHERS EDUCATION COLLEGE MALDA (Id: C46654),Maldah,Teacher Training,59,41,100,9,2,11,0,0,9.1,3.04
974,West Bengal,University of Gour Banga Malda (Id: U0571),Satish B. Ed. College (Id: C42669),Maldah,Teacher Training,39,61,100,7,3,10,1,1,10,10
975,West Bengal,University of Gour Banga Malda (Id: U0571),Uttar Banga Womens' B. Ed. College (Id: C42685),Maldah,Teacher Training,0,100,100,6,2,8,1,0,12.5,7.5
976,West Bengal,University of Gour Banga Malda (Id: U0571),Vibekananda Teacher Training College (Id: C42683),Maldah,Teacher Training,58,42,100,5,2,7,1,0,14.29,8.1
977,West Bengal,University of Gour Banga Malda (Id: U0571),Vidyasagar Teacher Training College (Id: C42688),Maldah,Teacher Training,66,34,100,4,3,7,0,1,14.29,8.1
978,West Bengal,Vidya Sagar University Midnapore (Id: U0588),Vidyasagar Teachers' Traning College (Id: C19043),Paschim Medinipur,Teacher Training,47,49,96,6,1,7,1,1,13.72,11.24
979,West Bengal,Vidya Sagar University Midnapore (Id: U0588),Vivekananda Mission Ashram (Id: C19108),Purba Medinipur,Nursing,15,22,37,12,1,13,0,0,2.85,0.95
980,West Bengal,West Bengal State University Kolkata (Id: U0590),Nandalal Ghosh B.T.College (Id: C43364),North Twenty Four Parganas,Teacher Training,54,40,94,7,4,11,0,0,8.55,2.85
981,West Bengal,West Bengal University of Technology Kolkata (Id: U0592),Calcutta Institute of Pharmaceutical Technology and Allied Health Sciences 159PHAR (Id: C6312),Haora,Technical/Polytechnic,208,92,300,31,6,37,0,0,8.11,2.71
982,West Bengal,West Bengal University of Technology Kolkata (Id: U0592),Calcutta Institute of Pharmaceutical Technology and Allied Health Sciences 159 (Id: C6312),Haora,Technical/Polytechnic,208,92,300,31,6,37,0,0,8.11,2.71
983,West Bengal,West Bengal University of Technology Kolkata (Id: U0592),Narula Institute of Technology 127MBA (Id: C6140),North Twenty Four Parganas,Technical/Polytechnic,24,22,46,6,3,9,0,1,5.12,5.04
984,West Bengal,West Bengal University of Technology Kolkata (Id: U0592),Narula Institute of Technology 305 (Id: C6140),North Twenty Four Parganas,Technical/Polytechnic,24,22,46,6,3,9,1,0,5.12,5.04
985,West Bengal,West Bengal University of Technology Kolkata (Id: U0592),West Bengal State Council for Science and Technology 243 (Id: C6252),Barddhaman,Technical/Polytechnic,6,5,11,6,5,11,1,0,1,3.67
986,West Bengal,West Bengal University of Technology Kolkata (Id: U0592),West Bengal State Council for Science and Technology 243 (Id: C6252),North Twenty Four Parganas,Technical/Polytechnic,6,5,11,6,5,11,1,1,1,7
987,West Bengal,West Bengal University of Technology Kolkata (Id: U0592),West Bengal State Council for Science and Technology 243WBUT (Id: C6252),Barddhaman,Technical/Polytechnic,6,5,11,6,5,11,0,0,1,0.34
